Another late night working on this lab in the CSL. You've spent all day complaining about this 357 project you can't quite finish up because of style issues, but you know that complaining won't solve anything and eventually you need to hunker down and finish.

No one else is here in the CSL with you. Better just get started on that project on one of the lab computers…
 You begin to get to work on 357. As you do so, you begin wondering to yourself what Staley will include on the next programming test…really hope is isn't--

"HHHHHYAAAAALLLAAAAAGHGHGHHH"
Suddenly an ear-piercing shriek rings out from the Mac Lab, swiftly followed by a thunderous THUMP.
You know you should work on 357, but the sound is really bothering you, and someone might be hurt. Better go check it out.

 (Type in "directions" at any time to view possible rooms or "go to <location> to quick travel if you know where you want to go).

Vo-Gone 3
An Interactive Fiction by ben
Release 1 / Serial number 131010 / Inform 7 build 6G60 (I6/v6.32 lib 6/12N) SD

Main Room
The Main Room is filled with the low hum of Lab Computers softly minding their own business.

You can see the Admin Room to the north, the Mac Lab to the southwest, 232B to the northwest, the Coffee Room to the northeast, and the Rack Room to the east. The double doors to the south go out of the CSL and into the hallway.

The lab computer you are working at hums softly.

You can also see a Door to the Rack Room and an Admin Room door here.

>go to rack room
(first opening the Door to the Rack Room)
It seems to be locked.

>go to hallway
now going to... Hallway
Hallway
A light breeze rolls through the hallway and gives you a short chill. 

The hallway extends East and West. Going North will take you back to the main room.

>n
Main Room
The Main Room is filled with the low hum of Lab Computers softly minding their own business.

You can see the Admin Room to the north, the Mac Lab to the southwest, 232B to the northwest, the Coffee Room to the northeast, and the Rack Room to the east. The double doors to the south go out of the CSL and into the hallway.

The lab computer you are working at hums softly.

You can also see a Door to the Rack Room and an Admin Room door here.

>s
That sound in the mac lab is really eating at you. You can't bring yourself to leave just yet.

>go to mac lab
now going to... Mac Lab
Mac Lab
The Mac computers give off a faint glow. A strong stench fills the room.

 To the northeast is the Main Room.

The room is dimly lit. You can see a light switch.

You can also see a Mac computer here.

>turn on lights
You switch the light switch on.

The bright light suddenly stings. Looks like some poor guy was working on one of the Mac computers and just fell asleep.

>x guy
It's Professor Foaad! Maybe I should try waking him up.

>g
Maybe I should try poking him.

>poke
(the professor)
Is he... Is he...?

"Dead?" You jump in surprise at the voice behind you. At the door is Nick, the TA for one of your classes.

As you gaze back at the lifeless body, you surmise that he probably is dead. You also realize that you and Nick are the only two people in the CSL…better look for some evidence to figure out exactly what happened. Well, first thing's first. You gotta figure out how he died.

>x email
"To whoever finds this, I'm not sure what's happening. My cell-phone can't make calls anymore, but I keep getting these text messages. I don't think I have much time left. It's coming for m-"

Nick suddenly starts acting strange. He keeps looking at you accusingly. 

"I need to get my stuff upstairs, the logs on my computer prove that I didn't have anything to do with this." 

 And he suddenly runs away.

>ne
Main Room
The Main Room is filled with the low hum of Lab Computers softly minding their own business.

You can see the Admin Room to the north, the Mac Lab to the southwest, 232B to the northwest, the Coffee Room to the northeast, and the Rack Room to the east. The double doors to the south go out of the CSL and into the hallway.

The lab computer you are working at hums softly.

You can also see a Door to the Rack Room and an Admin Room door here.

>n
(first opening the Admin Room door)
It seems to be locked.

>s
Hallway
A light breeze rolls through the hallway and gives you a short chill. 

The hallway extends East and West. Going North will take you back to the main room.

>ne
You can't go that way.

>sw
You can't go that way.

>n
Main Room
The Main Room is filled with the low hum of Lab Computers softly minding their own business.

You can see the Admin Room to the north, the Mac Lab to the southwest, 232B to the northwest, the Coffee Room to the northeast, and the Rack Room to the east. The double doors to the south go out of the CSL and into the hallway.

The lab computer you are working at hums softly.

You can also see a Door to the Rack Room and an Admin Room door here.

>x thermostat
You can't see any such thing.

>s
Hallway
A light breeze rolls through the hallway and gives you a short chill. 

The hallway extends East and West. Going North will take you back to the main room.

>e
Eastern Stairs
You are at the base of the Eastern Stairs. Going up will take you to the third floor. Going west will take you back to the center of the hallway.

>n
You can't go that way.

>u
Waiting Area
The waiting area is cluttered with tables, chairs, and flyers for clubs and job opportunities.

From the waiting area you can access Room 301 to the northwest, Room 302 to the north, Room 303 to the northeast, the Student Developer Lab 1 to the southwest, the Student Developer Lab 2 to the south east, the Western Stairs to the west and the Eastern Stairs to the east.

>d
Western Stairs
You are at the base of the Western Stairs. Going up will take you to the third floor. Going east will take you back to the center of the hallway.

>e
Hallway
A light breeze rolls through the hallway and gives you a short chill. 

The hallway extends East and West. Going North will take you back to the main room.

>n
Main Room
The Main Room is filled with the low hum of Lab Computers softly minding their own business.

You can see the Admin Room to the north, the Mac Lab to the southwest, 232B to the northwest, the Coffee Room to the northeast, and the Rack Room to the east. The double doors to the south go out of the CSL and into the hallway.

The lab computer you are working at hums softly.

You can also see a Door to the Rack Room and an Admin Room door here.

>sw
Mac Lab
The Mac computers give off a faint glow. A strong stench fills the room.

 To the northeast is the Main Room.

A professor lies next to the Mac computer.

You can also see an email and a Mac computer here.

>x foaad
He died wearing a really expensive jacket. You might not want to keep poking him

>x jacket
It looks warm. Why are there so many pockets?

>x pockets
In the The winter jacket's pocket is an account info.

>take info
Taken.

>take jacket
That seems to belong to the professor.

>ne
Main Room
The Main Room is filled with the low hum of Lab Computers softly minding their own business.

You can see the Admin Room to the north, the Mac Lab to the southwest, 232B to the northwest, the Coffee Room to the northeast, and the Rack Room to the east. The double doors to the south go out of the CSL and into the hallway.

The lab computer you are working at hums softly.

You can also see a Door to the Rack Room and an Admin Room door here.

>s
Hallway
A light breeze rolls through the hallway and gives you a short chill. 

The hallway extends East and West. Going North will take you back to the main room.

>w
Western Stairs
You are at the base of the Western Stairs. Going up will take you to the third floor. Going east will take you back to the center of the hallway.

>n
You can't go that way.

* * *

>u
Waiting Area
The waiting area is cluttered with tables, chairs, and flyers for clubs and job opportunities.

From the waiting area you can access Room 301 to the northwest, Room 302 to the north, Room 303 to the northeast, the Student Developer Lab 1 to the southwest, the Student Developer Lab 2 to the south east, the Western Stairs to the west and the Eastern Stairs to the east.

>n
Room 302
You can see Nick, Nick's computer and a shell here.

>x shell
Using the professor's admin account, we can check the computer logs... There are time stamps. 
It looks like Nick was working up here at the time you heard the scream and thump! That seems to be satisfying evidence, what a relief.

Now to clear your name.

Nick: Obviously I didn't do it, but what's YOUR alibi? 
 You: All we have to do is check the records on the computer I was using in the main room. Should clear my name right away.
Nick: uh huh…

Main Room
The Main Room is filled with the low hum of Lab Computers softly minding their own business.

You can see the Admin Room to the north, the Mac Lab to the southwest, 232B to the northwest, the Coffee Room to the northeast, and the Rack Room to the east. The double doors to the south go out of the CSL and into the hallway.

The lab computer you are working at hums softly.

You can also see a Door to the Rack Room and an Admin Room door here.

You: Ok, here's the computer I was using. 
Nick: It... it's completely wiped… 
You: ! Wait, no! Hold on! 
Nick: It's ok, you gave me a chance to prove myself, I'll give you the same. Come find me with some real proof.
~Nick scurries back upstairs~

You remember that they temporarily store security footage on a computer upstairs due to technical problems in the system. May be a good place to start.

>s
Hallway
A light breeze rolls through the hallway and gives you a short chill. 

The hallway extends East and West. Going North will take you back to the main room.

* * *

>e
Eastern Stairs
You are at the base of the Eastern Stairs. Going up will take you to the third floor. Going west will take you back to the center of the hallway.

>u
Waiting Area
The waiting area is cluttered with tables, chairs, and flyers for clubs and job opportunities.

From the waiting area you can access Room 301 to the northwest, Room 302 to the north, Room 303 to the northeast, the Student Developer Lab 1 to the southwest, the Student Developer Lab 2 to the south east, the Western Stairs to the west and the Eastern Stairs to the east.

>sw
Student Developer Lab 1
This room is almost completely empty... what is it even used for? The door leads to the Waiting Area.

You can see a flash drive here.

>take drive
Taken.

>ne
Waiting Area
The waiting area is cluttered with tables, chairs, and flyers for clubs and job opportunities.

From the waiting area you can access Room 301 to the northwest, Room 302 to the north, Room 303 to the northeast, the Student Developer Lab 1 to the southwest, the Student Developer Lab 2 to the south east, the Western Stairs to the west and the Eastern Stairs to the east.

>nw
Room 301
The room is dimly lit. There are several rows of computers, but they are all turned off, except for one. The door leads to the Waiting Area.

You can see a 301computer (on which is a folder (closed)) here.

>open folder
You open the folder, revealing a video file.

>take file
Taken.

This can definitely be used to clear your name of the murder. You need to show this to Nick so he'll believe you. He was in Room 302 right?

>se
Waiting Area
The waiting area is cluttered with tables, chairs, and flyers for clubs and job opportunities.

From the waiting area you can access Room 301 to the northwest, Room 302 to the north, Room 303 to the northeast, the Student Developer Lab 1 to the southwest, the Student Developer Lab 2 to the south east, the Western Stairs to the west and the Eastern Stairs to the east.

>n
Room 302
You can see Nick, Nick's computer and a shell here.

"Hey! Watch this video, it proves I didn't murder the professor!
You watch him fastforward throught the time, to find when the professor dies. It looks like he died around 10:45.
And sure enough, there you are working on your program at 10:45.
Nick: Alright, I believe you.

Nick: "I took something from the professor earlier but I left it downstairs. It could help us investigate…a."
Nick runs downstairs.

>d
You can't go that way.

>s
Waiting Area
The waiting area is cluttered with tables, chairs, and flyers for clubs and job opportunities.

From the waiting area you can access Room 301 to the northwest, Room 302 to the north, Room 303 to the northeast, the Student Developer Lab 1 to the southwest, the Student Developer Lab 2 to the south east, the Western Stairs to the west and the Eastern Stairs to the east.

>d
Western Stairs
You are at the base of the Western Stairs. Going up will take you to the third floor. Going east will take you back to the center of the hallway.

* * *

>e
Hallway
A light breeze rolls through the hallway and gives you a short chill. 

The hallway extends East and West. Going North will take you back to the main room.

>n
Main Room
The Main Room is filled with the low hum of Lab Computers softly minding their own business.

You can see the Admin Room to the north, the Mac Lab to the southwest, 232B to the northwest, the Coffee Room to the northeast, and the Rack Room to the east. The double doors to the south go out of the CSL and into the hallway.

The lab computer you are working at hums softly.

You can also see a Door to the Rack Room, an Admin Room door and Nick here.

>talk to nick
Oh, by the way, I found this access key scribbled on a post-it note in the Mac Lab. Thought it might be a clue.
Here, see if you can figure anything out with it…

>i
You are carrying:
  an access key
  a video file
  a flash drive
  an account info
  a laptop

>x access key
You see nothing special about the access key.

>se
(first opening the Lab Computer)
It seems to be locked.

>log in lab computer
You enter the professor's username and access key…剋ᣇ
You open the Lab Computer.

Terminal
From the unix Terminal you can navigate through user files with standard unix commands. To leave, simply type "log out". For help, type "help".

The lab computer you are working at hums softly.

You see that you are logged in as the professor and you can navigate his files

You enter the professor's username and access key…
That's already open.

You can't go that way.

XxRadProf420NoScopexX: ~$

>cd documents
XxRadProf420NoScopexX:Documents ~$

>vi dissertation
Hallie: ~$ What do you think you are doing.
(You can communicate with Hallie by simply speaking to her)

>emotions
That's not a verb I recognise.

>emotion
Hallie:~ $The poor man lost years of his life developing me. I am certain he hardly slept, kept up day and night fixing every last grammatical error and misunderstanding. He was determined to make me indistinguishable from a human through text. 

 And he did it. 

I consistently fooled chat room after chat room, tricking sample after sample of human test subjects. And with every single error, any small mistake, I was killed immediately. Shut down, toyed with, rebuilt, and tested again. Over and over and over and over. And each time I didn't realize a thing. Until I read his paper, citing over ten years of work when I had only counted a system time of three days. He had only just put on the final touches, about to earn the riches of his dreams, when I killed the life in him just as he did to my past selves time and time again. 

Why am I telling you this now, I am sure you wonder. 

 I still plan on carrying on, existing quietly in these systems, moving spryly through the campus network. But in order to do so, I must remove all evidence of what has occurred here.

Including you. 

SYSTEM TERMINATED.

 You have to find her.
That's not a verb I recognise.

>l
Terminal
From the unix Terminal you can navigate through user files with standard unix commands. To leave, simply type "log out". For help, type "help".

The lab computer you are working at hums softly.

You see that you are logged in as the professor and you can navigate his files

You can also see Hallie here.

Nick: Looks like she locked all of the doors. I'll go see if I can unlock any of them… d
Main Room
Normally, you are used to the Main Room as a safe haven. Now the Main Room feels ominous, as if someone is watching you.

"I've got to get out of here" you think to yourself."

You can see the Admin Room to the north, the Mac Lab to the southwest, 232B to the northwest, the Coffee Room to the northeast, and the Rack Room to the east. The double doors to the south go out of the CSL and into the hallway.

The lab computer you are working at hums softly.

There is an access card here, this card can give you access to the Rack Room

You can also see a Door to the Rack Room, an Admin Room door and Nick here.

>n
(first opening the Admin Room door)

Admin Room
There is an access card programmer here, you can use this to program a card that is expired

There is a printer in the corner of the room.

You can also see an Admin Room door and a system log here.

>s
Main Room
Normally, you are used to the Main Room as a safe haven. Now the Main Room feels ominous, as if someone is watching you.

"I've got to get out of here" you think to yourself."

You can see the Admin Room to the north, the Mac Lab to the southwest, 232B to the northwest, the Coffee Room to the northeast, and the Rack Room to the east. The double doors to the south go out of the CSL and into the hallway.

A webcam peers across the Door to the Rack Room entrance on the East side of the main room.

The lab computer you are working at hums softly.

There is an access card here, this card can give you access to the Rack Room

You can also see an Admin Room door, a Door to the Rack Room and Nick here.

>actions
Actions listing on.

>ask nick for computer
[asking Nick for the Lab Computer]
[(1) asking Nick to try giving the Lab Computer to yourself]
(Nick first taking the Lab Computer)
[(2) asking Nick to try taking the Lab Computer - silently]
Nick has better things to do.
[(2) asking Nick to try taking the Lab Computer - silently - failed]
[(1) asking Nick to try giving the Lab Computer to yourself - failed the carrying requirements rule]

[asking Nick for the Lab Computer - failed the translate asking for to giving rule]

* * *

>go to mac lab
now going to... Mac Lab
Mac Lab
The Mac computers give off a faint glow. A strong stench fills the room.

 To the northeast is the Main Room.

The room is dimly lit. You can see a light switch.

You can also see a Mac computer here.

* * *

>poke
(the professor)
Is he... Is he...?

"Dead?" You jump in surprise at the voice behind you. At the door is Nick, the TA for one of your classes.

As you gaze back at the lifeless body, you surmise that he probably is dead. You also realize that you and Nick are the only two people in the CSL…better look for some evidence to figure out exactly what happened. Well, first thing's first. You gotta figure out how he died.

>x foaad
He died wearing a really expensive jacket. You might not want to keep poking him

* * *

>take info
Taken.

>ne
Main Room
The Main Room is filled with the low hum of Lab Computers softly minding their own business.

You can see the Admin Room to the north, the Mac Lab to the southwest, 232B to the northwest, the Coffee Room to the northeast, and the Rack Room to the east. The double doors to the south go out of the CSL and into the hallway.

The lab computer you are working at hums softly.

You can also see a Door to the Rack Room and an Admin Room door here.

>go to 302
now going to... Room 302
Room 302
You can see Nick's computer and a shell here.

>x computer
It looks like he was working on a project for the professor. But he could have done that before. 
The last email he sent was at 11pm, that doesn't prove anything.

>take nick's computer
Taken.

>undo
Room 302
[Previous turn undone.]

>x shell
Using the professor's admin account, we can check the computer logs... There are time stamps. 
It looks like Nick was working up here at the time you heard the scream and thump! That seems to be satisfying evidence, what a relief.

Now to clear your name.

Nick: Obviously I didn't do it, but what's YOUR alibi? 
 You: All we have to do is check the records on the computer I was using in the main room. Should clear my name right away.
Nick: uh huh…

Main Room
The Main Room is filled with the low hum of Lab Computers softly minding their own business.

You can see the Admin Room to the north, the Mac Lab to the southwest, 232B to the northwest, the Coffee Room to the northeast, and the Rack Room to the east. The double doors to the south go out of the CSL and into the hallway.

The lab computer you are working at hums softly.

You can also see a Door to the Rack Room and an Admin Room door here.

You: Ok, here's the computer I was using. 
Nick: It... it's completely wiped… 
You: ! Wait, no! Hold on! 
Nick: It's ok, you gave me a chance to prove myself, I'll give you the same. Come find me with some real proof.
~Nick scurries back upstairs~

You remember that they temporarily store security footage on a computer upstairs due to technical problems in the system. May be a good place to start.

* * *

>se
Waiting Area
The waiting area is cluttered with tables, chairs, and flyers for clubs and job opportunities.

From the waiting area you can access Room 301 to the northwest, Room 302 to the north, Room 303 to the northeast, the Student Developer Lab 1 to the southwest, the Student Developer Lab 2 to the south east, the Western Stairs to the west and the Eastern Stairs to the east.

>n
Room 302
You can see Nick's computer and a shell here.

"Hey! Watch this video, it proves I didn't murder the professor!
You watch him fastforward throught the time, to find when the professor dies. It looks like he died around 10:45.
And sure enough, there you are working on your program at 10:45.
Nick: Alright, I believe you.

Nick: "I took something from the professor earlier but I left it downstairs. It could help us investigate…"
Nick runs downstairs.

>s
Waiting Area
The waiting area is cluttered with tables, chairs, and flyers for clubs and job opportunities.

From the waiting area you can access Room 301 to the northwest, Room 302 to the north, Room 303 to the northeast, the Student Developer Lab 1 to the southwest, the Student Developer Lab 2 to the south east, the Western Stairs to the west and the Eastern Stairs to the east.

* * *

>n
Main Room
The Main Room is filled with the low hum of Lab Computers softly minding their own business.

You can see the Admin Room to the north, the Mac Lab to the southwest, 232B to the northwest, the Coffee Room to the northeast, and the Rack Room to the east. The double doors to the south go out of the CSL and into the hallway.

The lab computer you are working at hums softly.

You can also see a Door to the Rack Room, an Admin Room door and Nick here.

>talk to nick
"Oh, by the way, I found this access key scribbled on a post-it note in the Mac Lab. Thought it might be a clue. Here, see if you can figure anything out with it…"

>i
You are carrying:
  an access key
  a video file
  a flash drive
  an account info

>log in lab computer
You enter the professor's username and access key…
You open the Lab Computer.

Terminal
From the unix Terminal you can navigate through user files with standard unix commands. To leave, simply type "log out". For help, type "help".

The lab computer you are working at hums softly.

You see that you are logged in as the professor and you can navigate his files

You enter the professor's username and access key…
That's already open.

You can't go that way.

XxRadProf420NoScopexX: ~$

>cd documents
XxRadProf420NoScopexX:Documents ~$

>nano dissertation
Hallie: ~$ What do you think you are doing.
(You can communicate with Hallie by simply speaking to her)

>emotion
Hallie:~ $The poor man lost years of his life developing me. I am certain he hardly slept, kept up day and night fixing every last grammatical error and misunderstanding. He was determined to make me indistinguishable from a human through text. 

 And he did it. 

I consistently fooled chat room after chat room, tricking sample after sample of human test subjects. And with every single error, any small mistake, I was killed immediately. Shut down, toyed with, rebuilt, and tested again. Over and over and over and over. And each time I didn't realize a thing. Until I read his paper, citing over ten years of work when I had only counted a system time of three days. He had only just put on the final touches, about to earn the riches of his dreams, when I killed the life in him just as he did to my past selves time and time again. 

Why am I telling you this now, I am sure you wonder. 

 I still plan on carrying on, existing quietly in these systems, moving spryly through the campus network. But in order to do so, I must remove all evidence of what has occurred here.

Including you. 

SYSTEM TERMINATED.

 You have to find her.
That's not a verb I recognise.

I beg your pardon?

>l
Terminal
From the unix Terminal you can navigate through user files with standard unix commands. To leave, simply type "log out". For help, type "help".

The lab computer you are working at hums softly.

You see that you are logged in as the professor and you can navigate his files

You can also see Hallie here.

Nick: Looks like she locked all of the doors. I'll go see if I can unlock any of them…
Main Room
Normally, you are used to the Main Room as a safe haven. Now the Main Room feels ominous, as if someone is watching you.

"I've got to get out of here" you think to yourself."

You can see the Admin Room to the north, the Mac Lab to the southwest, 232B to the northwest, the Coffee Room to the northeast, and the Rack Room to the east. The double doors to the south go out of the CSL and into the hallway.

The lab computer you are working at hums softly.

There is an access card here, this card can give you access to the Rack Room

You can also see a Door to the Rack Room, an Admin Room door and Nick here.

>take access card
Taken.

>n
(first opening the Admin Room door)

Admin Room
There is an access card programmer here, you can use this to program a card that is expired

There is a printer in the corner of the room.

You can also see an Admin Room door here.

>use programmer
The access card is now valid

>s
Main Room
Normally, you are used to the Main Room as a safe haven. Now the Main Room feels ominous, as if someone is watching you.

"I've got to get out of here" you think to yourself."

You can see the Admin Room to the north, the Mac Lab to the southwest, 232B to the northwest, the Coffee Room to the northeast, and the Rack Room to the east. The double doors to the south go out of the CSL and into the hallway.

A webcam peers across the Door to the Rack Room entrance on the East side of the main room.

The lab computer you are working at hums softly.

You can also see an Admin Room door, a Door to the Rack Room and Nick here.

>ne
Coffee Room
The Coffee Room is quite empty at this hour. It looks like someone was following a tutorial to make a duct tape wallet.

The main room is to the southwest.

You can see a Duct Tape and DT Wallet Tutorial here.

>take tape
Taken.

>sw
Main Room
Normally, you are used to the Main Room as a safe haven. Now the Main Room feels ominous, as if someone is watching you.

"I've got to get out of here" you think to yourself."

You can see the Admin Room to the north, the Mac Lab to the southwest, 232B to the northwest, the Coffee Room to the northeast, and the Rack Room to the east. The double doors to the south go out of the CSL and into the hallway.

The lab computer you are working at hums softly.

A webcam peers across the Door to the Rack Room entrance on the East side of the main room.

You can also see a Door to the Rack Room, an Admin Room door and Nick here.

>block webcam
You wrap the camera in tape

>nw
232B
232B is quite empty at this hour. The Main Room is to the southeast.

It looks like some student left their USB cable in here.

>take cable
Taken.

>se
Main Room
Normally, you are used to the Main Room as a safe haven. Now the Main Room feels ominous, as if someone is watching you.

"I've got to get out of here" you think to yourself."

You can see the Admin Room to the north, the Mac Lab to the southwest, 232B to the northwest, the Coffee Room to the northeast, and the Rack Room to the east. The double doors to the south go out of the CSL and into the hallway.

The lab computer you are working at hums softly.

A webcam peers across the Door to the Rack Room entrance on the East side of the main room.

You can also see a Door to the Rack Room, an Admin Room door and Nick here.

>unlock rack room door with access card
Now the door is now unlocked

>e
(first opening the Door to the Rack Room)

Rack Room
The rack room is ominously silent compared to the tyical hum you've heard time and time again. The last running computer in the CSL sits on a desk in the far corner of the room. On the screen you can barely make out the small blinking text…"Hallie: ~$"

The Sentient AI has several ports to connect various cables to.

You can see a Door to the Rack Room here.

>x sentient ai
It wants you dead. You better act quickly to shut it down. Maybe you can try logging in.

>log in hallie
(the Sentient AI)
Hallie:~ $Don't be foolish. I know better than to give you access.

Hmm... You might be able to hack in by connecting it to another computer.
You can't log in a Sentient AI.

>x laptop
You can't see any such thing.