>log in lab computer
You begin typing your username and password. As you do so, you begin wondering to yourself what Staley will include on the next programming test…really hope it isn't--

"HHHHHYAAAAALLLAAAAAGHGHGHHH"
Suddenly an ear-piercing shriek rings out from the Mac Lab, swiftly followed by a thunderous THUMP.

You know you should work on 357, but the sound is really bothering you, and someone might be hurt. Better go check it out.

You begin to get to work on 357. As you do so, you begin wondering to yourself what Staley will include on the next programming test…really hope is isn't--

"HHHHHYAAAAALLLAAAAAGHGHGHHH"
Suddenly an ear-piercing shriek rings out from the Mac Lab, swiftly followed by a thunderous THUMP.

You know you should work on 357, but the sound is really bothering you, and someone might be hurt. Better go check it out.

>z
Time passes.

* * *

>z
Time passes.

You begin to get to work on 357. As you do so, you begin wondering to yourself what Staley will include on the next programming test…really hope is isn't--

"HHHHHYAAAAALLLAAAAAGHGHGHHH"
Suddenly an ear-piercing shriek rings out from the Mac Lab, swiftly followed by a thunderous THUMP.

You know you should work on 357, but the sound is really bothering you, and someone might be hurt. Better go check it out.

>log in lab computer
You know you should work on 357, but the sound is really bothering you, and someone might be hurt. Better go check it out.

* * *

>ls
Documents, Pictures and Books

>look
Main Room
The Main Room is filled with the low hum of Lab Computers softly minding their own business.

You can see the Admin Room to the north, the Mac Lab to the southwest, 232B to the northwest, the Coffee Room to the northeast, and the Rack Room to the east. The double doors to the south go out of the CSL and into the hallway.

The lab computer you are working at hums softly.

You can also see a Door to the Rack Room and an Admin Room door here.

>directions
Coffee Room is northeast
232B is northwest
Mac Lab is southwest
Hallway is south

>sw
Mac Lab
The Mac computers give off a faint glow. A strong stench fills the room.

 To the northeast is the Main Room.

The room is dimly lit. You can see a light switch.

You can also see a Mac computer here.

>ne
Main Room
The Main Room is filled with the low hum of Lab Computers softly minding their own business.

You can see the Admin Room to the north, the Mac Lab to the southwest, 232B to the northwest, the Coffee Room to the northeast, and the Rack Room to the east. The double doors to the south go out of the CSL and into the hallway.

The lab computer you are working at hums softly.

You can also see a Door to the Rack Room and an Admin Room door here.

>go to mac lab
now going to... Mac Lab
Mac Lab
The Mac computers give off a faint glow. A strong stench fills the room.

 To the northeast is the Main Room.

The room is dimly lit. You can see a light switch.

You can also see a Mac computer here.

>go to room 302
now going to... Room 302
Room 302
You can see a friend's computer and a shell here.

>go to mac lab
now going to... Mac Lab
Mac Lab
The Mac computers give off a faint glow. A strong stench fills the room.

 To the northeast is the Main Room.

The room is dimly lit. You can see a light switch.

You can also see a Mac computer here.

>turn on light switch
You switch the light switch on.

The bright light suddenly stings. Looks like some poor guy was working on one of the Mac computers and just fell asleep.

>x mac computer
There seems to be an email being composed.

>x email
"To whoever finds this, I'm not sure what's happening. My cell-phone can't make calls anymore, but I keep getting these text messages. I don't think I have much time left. It's coming for m-"

>take email
Taken.

>x guy
It's Professor Foaad! Maybe I should try waking him up.

>wake foaad
Is he... Is he...?

"Dead?" You jump in surprise at the voice behind you. At the door is Nick, the TA for one of your classes.

As you gaze back at the lifeless body, you surmise that he probably is dead. You also realize that you and Nick are the only two people in the CSL…better look for some evidence to figure out exactly what happened.

Nick suddenly starts acting strange. He keeps looking at you accusingly. 

"I need to get my stuff upstairs, the logs on my computer prove that I didn't have anything to do with this." 

 And he suddenly runs away.

>directions
Main Room is northeast

>ne
Main Room
The Main Room is filled with the low hum of Lab Computers softly minding their own business.

You can see the Admin Room to the north, the Mac Lab to the southwest, 232B to the northwest, the Coffee Room to the northeast, and the Rack Room to the east. The double doors to the south go out of the CSL and into the hallway.

The lab computer you are working at hums softly.

You can also see a Door to the Rack Room and an Admin Room door here.

* * *

>z
Time passes.

You begin to get to work on 357. As you do so, you begin wondering to yourself what Staley will include on the next programming test…really hope is isn't--

"HHHHHYAAAAALLLAAAAAGHGHGHHH"
Suddenly an ear-piercing shriek rings out from the Mac Lab, swiftly followed by a thunderous THUMP.

You know you should work on 357, but the sound is really bothering you, and someone might be hurt. Better go check it out.

>directions
Coffee Room is northeast
232B is northwest
Mac Lab is southwest
Hallway is south

* * *

>z
Time passes.

You begin to get to work on 357. As you do so, you begin wondering to yourself what Staley will include on the next programming test…really hope is isn't--

"HHHHHYAAAAALLLAAAAAGHGHGHHH"
Suddenly an ear-piercing shriek rings out from the Mac Lab, swiftly followed by a thunderous THUMP.

You know you should work on 357, but the sound is really bothering you, and someone might be hurt. Better go check it out.

>x lab computers
I only understood you as far as wanting to examine the Lab Computer.

>x lab computer
You can access the terminal by logging in a lab computer. You can log in a lab computer by saying "log in lab computer"

>log in lab computer
You begin typing your username and password. As you do so, you begin wondering to yourself what Staley will include on the next programming test…really hope it isn't--

"HHHHHYAAAAALLLAAAAAGHGHGHHH"
Suddenly an ear-piercing shriek rings out from the Mac Lab, swiftly followed by a thunderous THUMP.

You know you should work on 357, but the sound is really bothering you, and someone might be hurt. Better go check it out.

* * *

>go to rack room door
(first opening the Door to the Rack Room)
It seems to be locked.

You begin to get to work on 357. As you do so, you begin wondering to yourself what Staley will include on the next programming test…really hope is isn't--

"HHHHHYAAAAALLLAAAAAGHGHGHHH"
Suddenly an ear-piercing shriek rings out from the Mac Lab, swiftly followed by a thunderous THUMP.

You know you should work on 357, but the sound is really bothering you, and someone might be hurt. Better go check it out.

>look
Main Room
The Main Room is filled with the low hum of Lab Computers softly minding their own business.

You can see the Admin Room to the north, the Mac Lab to the southwest, 232B to the northwest, the Coffee Room to the northeast, and the Rack Room to the east. The double doors to the south go out of the CSL and into the hallway.

The lab computer you are working at hums softly.

You can also see a Door to the Rack Room and an Admin Room door here.

* * *

>directions
Coffee Room is northeast
232B is northwest
Mac Lab is southwest
Hallway is south

* * *

>look
Main Room
The Main Room is filled with the low hum of Lab Computers softly minding their own business.

You can see the Admin Room to the north, the Mac Lab to the southwest, 232B to the northwest, the Coffee Room to the northeast, and the Rack Room to the east. The double doors to the south go out of the CSL and into the hallway.

The lab computer you are working at hums softly.

You can also see a Door to the Rack Room and an Admin Room door here.

>sw
Mac Lab
The Mac computers give off a faint glow. A strong stench fills the room.

 To the northeast is the Main Room.

The room is dimly lit. You can see a light switch.

You can also see a Mac computer here.

>x mac computer
There seems to be an email being composed.

>x email
You can't see any such thing.

>read email
You can't see any such thing.

>turn on lights
You switch the light switch on.

The bright light suddenly stings. Looks like some poor guy was working on one of the Mac computers and just fell asleep.

>x email
"To whoever finds this, I'm not sure what's happening. My cell-phone can't make calls anymore, but I keep getting these text messages. I don't think I have much time left. It's coming for m-"

>x guy
It's Professor Foaad! Maybe I should try waking him up.

* * *

>wake foaad
Is he... Is he...?

"Dead?" You jump in surprise at the voice behind you. At the door is Nick, the TA for one of your classes.

As you gaze back at the lifeless body, you surmise that he probably is dead. You also realize that you and Nick are the only two people in the CSL…better look for some evidence to figure out exactly what happened.

Nick suddenly starts acting strange. He keeps looking at you accusingly. 

"I need to get my stuff upstairs, the logs on my computer prove that I didn't have anything to do with this." 

 And he suddenly runs away.

>x foaad
He died wearing a really expensive jacket. You might not want to keep poking him

* * *

>x pockets
In the The winter jacket's pocket is an account info.

>take account info
Taken.

>look
Mac Lab
The Mac computers give off a faint glow. A strong stench fills the room.

 To the northeast is the Main Room.

A professor lies next to the Mac computer.

You can also see an email and a Mac computer here.

>ne
Main Room
The Main Room is filled with the low hum of Lab Computers softly minding their own business.

You can see the Admin Room to the north, the Mac Lab to the southwest, 232B to the northwest, the Coffee Room to the northeast, and the Rack Room to the east. The double doors to the south go out of the CSL and into the hallway.

The lab computer you are working at hums softly.

You can also see a Door to the Rack Room and an Admin Room door here.

* * *

>s
Hallway
A light breeze rolls through the hallway and gives you a short chill. 

The hallway extends East and West. Going North will take you back to the main room.

>n
Main Room
The Main Room is filled with the low hum of Lab Computers softly minding their own business.

You can see the Admin Room to the north, the Mac Lab to the southwest, 232B to the northwest, the Coffee Room to the northeast, and the Rack Room to the east. The double doors to the south go out of the CSL and into the hallway.

The lab computer you are working at hums softly.

You can also see a Door to the Rack Room and an Admin Room door here.

>n
(first opening the Admin Room door)
It seems to be locked.

>nw
232B
232B is quite empty at this hour. The Main Room is to the southeast.

It looks like some student left their USB cable in here.

>take usb cable
Taken.

>se
Main Room
The Main Room is filled with the low hum of Lab Computers softly minding their own business.

You can see the Admin Room to the north, the Mac Lab to the southwest, 232B to the northwest, the Coffee Room to the northeast, and the Rack Room to the east. The double doors to the south go out of the CSL and into the hallway.

The lab computer you are working at hums softly.

You can also see a Door to the Rack Room and an Admin Room door here.

>ne
Coffee Room
The Coffee Room is quite empty at this hour. It looks like someone was following a tutorial to make a duct tape wallet.

The main room is to the southwest.

You can see a Duct Tape and DT Wallet Tutorial here.

>take duct tape
Taken.

>read dt wallet tutorial
It's a print-out of a web page about making wallets using only duct tape. Interesting concept.

>x dt wallet tutoral
I only understood you as far as wanting to examine DT Wallet Tutorial.

>takedt wallet tutorial
That's not a verb I recognise.

>take dt wallet tutorial
Taken.

>sw
Main Room
The Main Room is filled with the low hum of Lab Computers softly minding their own business.

You can see the Admin Room to the north, the Mac Lab to the southwest, 232B to the northwest, the Coffee Room to the northeast, and the Rack Room to the east. The double doors to the south go out of the CSL and into the hallway.

The lab computer you are working at hums softly.

You can also see a Door to the Rack Room and an Admin Room door here.

>e
(first opening the Door to the Rack Room)
It seems to be locked.

>directions
Coffee Room is northeast
232B is northwest
Mac Lab is southwest
Hallway is south

>s
Hallway
A light breeze rolls through the hallway and gives you a short chill. 

The hallway extends East and West. Going North will take you back to the main room.

>directions
Main Room is north
Eastern Stairs is east
Western Stairs is west

>e
Eastern Stairs
You are at the base of the Eastern Stairs. Going up will take you to the third floor. Going west will take you back to the center of the hallway.

* * *

>u
Waiting Area
The waiting area is cluttered with tables, chairs, and flyers for clubs and job opportunities.

From the waiting area you can access Room 301 to the northwest, Room 302 to the north, Room 303 to the northeast, the Student Developer Lab 1 to the southwest, the Student Developer Lab 2 to the south east, the Western Stairs to the west and the Eastern Stairs to the east.

>nw
Room 301
The room is dimly lit. There are several rows of computers, but they are all turned off, except for one. The door leads to the Waiting Area.

You can see a 301computer (on which is a folder (closed)) here.

>x 301 computer
You can't use multiple objects with that verb.

>x computer
You can't see any such thing.

>x 301computer
This computer is on. Looks like whoever was using this last forgot to log out.

On the 301computer is a folder (closed).

>open folder
You open the folder, revealing a video file.

>take file
You ought to focus on Nick clearing his name before snooping around some more.
You want to make sure nick didn't kill the professor.

>go through door
You can't see any such thing.

>directions
Waiting Area is southeast

>se
Waiting Area
The waiting area is cluttered with tables, chairs, and flyers for clubs and job opportunities.

From the waiting area you can access Room 301 to the northwest, Room 302 to the north, Room 303 to the northeast, the Student Developer Lab 1 to the southwest, the Student Developer Lab 2 to the south east, the Western Stairs to the west and the Eastern Stairs to the east.

>n
Room 302
You can see Nick, a friend's computer and a shell here.

>talk to nick
"Damnit my phone isn't working."

>x friend's computer
It looks like he was working on a project for the professor. But he could have done that before. 
The last email he sent was at 11pm, that doesn't prove anything.

>x shell
Checking the computer logs... There are time stamps. 
It looks like Nick was working up here at the time you heard the scream and thump! That seems to be satisfying evidence, what a relief.

Now to clear your name.

Nick: Obviously I didn't do it, but what's YOUR alibi? 
 You: All we have to do is check the records on the computer I was using in the main room. Should clear my name right away.
Nick: uh huh…

Main Room
The Main Room is filled with the low hum of Lab Computers softly minding their own business.

You can see the Admin Room to the north, the Mac Lab to the southwest, 232B to the northwest, the Coffee Room to the northeast, and the Rack Room to the east. The double doors to the south go out of the CSL and into the hallway.

The lab computer you are working at hums softly.

You can also see a Door to the Rack Room and an Admin Room door here.

You: Ok, here's the computer I was using. 
Nick: It... it's completely wiped… 
You: ! Wait, no! Hold on! 
Nick: It's ok, you gave me a chance to prove myself, I'll give you the same. Come find me with some real proof.
~Nick scurries back upstairs~

You remember that they sometimes temporarily store security footage on a computer upstairs due to technical problems in the system. May be a good place to start.

>s
Hallway
A light breeze rolls through the hallway and gives you a short chill. 

The hallway extends East and West. Going North will take you back to the main room.

* * *

>u
Waiting Area
The waiting area is cluttered with tables, chairs, and flyers for clubs and job opportunities.

From the waiting area you can access Room 301 to the northwest, Room 302 to the north, Room 303 to the northeast, the Student Developer Lab 1 to the southwest, the Student Developer Lab 2 to the south east, the Western Stairs to the west and the Eastern Stairs to the east.

>go to room 303
now going to... Room 303
Room 303

>x
What do you want to examine?

>look
Room 303

>directions
Waiting Area is southwest

>sw
Waiting Area
The waiting area is cluttered with tables, chairs, and flyers for clubs and job opportunities.

From the waiting area you can access Room 301 to the northwest, Room 302 to the north, Room 303 to the northeast, the Student Developer Lab 1 to the southwest, the Student Developer Lab 2 to the south east, the Western Stairs to the west and the Eastern Stairs to the east.

>sw
Student Developer Lab 1
This room is almost completely empty... what is it even used for? The door leads to the Waiting Area.

You can see a flash drive here.

>take flash drive
Taken.

>go to student developer lab 2
now going to... Student Developer Lab 2
Student Developer Lab 2

>nw
Waiting Area
The waiting area is cluttered with tables, chairs, and flyers for clubs and job opportunities.

From the waiting area you can access Room 301 to the northwest, Room 302 to the north, Room 303 to the northeast, the Student Developer Lab 1 to the southwest, the Student Developer Lab 2 to the south east, the Western Stairs to the west and the Eastern Stairs to the east.

>n
Room 302
You can see Nick, a friend's computer and a shell here.

>x shell
Checking the computer logs... There are time stamps. 
It looks like Nick was working up here at the time you heard the scream and thump! That seems to be satisfying evidence, what a relief.

Now to clear your name.

>s
Waiting Area
The waiting area is cluttered with tables, chairs, and flyers for clubs and job opportunities.

From the waiting area you can access Room 301 to the northwest, Room 302 to the north, Room 303 to the northeast, the Student Developer Lab 1 to the southwest, the Student Developer Lab 2 to the south east, the Western Stairs to the west and the Eastern Stairs to the east.

>nw
Room 301
The room is dimly lit. There are several rows of computers, but they are all turned off, except for one. The door leads to the Waiting Area.

You can see a 301computer (on which is a folder (in which is a video file)) here.

>take file
Taken.

This can definitely be used to clear your name of the murder. You need to show this to Nick so he'll believe you.

>go to main room
now going to... Main Room
Main Room
The Main Room is filled with the low hum of Lab Computers softly minding their own business.

You can see the Admin Room to the north, the Mac Lab to the southwest, 232B to the northwest, the Coffee Room to the northeast, and the Rack Room to the east. The double doors to the south go out of the CSL and into the hallway.

The lab computer you are working at hums softly.

You can also see a Door to the Rack Room and an Admin Room door here.

>talk to nick
You can't see any such thing.

>go to room 302
now going to... Room 302
Room 302
You can see Nick, a friend's computer and a shell here.

"Hey! Watch this video, it proves I didn't murder the professor!
You watch him fastforward throught the time, to find when the professor dies. It looks like he died around 10:45.
And sure enough, there you are working on your program at 10:45.
Nick: Alright, I believe you.

Nick: "I took something from the professor earlier but I left it downstairs. It could help us investigate…"
Nick runs downstairs.

>go to main room
now going to... Main Room
Main Room
The Main Room is filled with the low hum of Lab Computers softly minding their own business.

You can see the Admin Room to the north, the Mac Lab to the southwest, 232B to the northwest, the Coffee Room to the northeast, and the Rack Room to the east. The double doors to the south go out of the CSL and into the hallway.

The lab computer you are working at hums softly.

You can also see a Door to the Rack Room, an Admin Room door and Nick here.

>talk to nick
Oh, by the way, I found this access key scribbled on a post-it note in the Mac Lab. Thought it might be a clue.
Here, see if you can figure anything out with it…

>x post-it note
You can't see any such thing.

>read post-it note
You can't see any such thing.

>i
You are carrying:
  an access key
  a video file
  a flash drive
  DT Wallet Tutorial
  a Duct Tape
  an USB cable
  an account info
  a laptop