Another late night working on this lab in the CSL. You've spent all day complaining about this 357 project you can't quite finish up because of style issues, but you know that complaining won't solve anything and eventually you need to hunker down and finish.

No one else is here in the CSL with you. Better just get started on that project on one of the lab computers…ꂲ

Vo-Gone
An Interactive Fiction by DJABAC Game Studios
Release 1 / Serial number 131009 / Inform 7 build 6G60 (I6/v6.32 lib 6/12N) SD

Main Room
The Main Room is filled with the low hum of Lab Computers softly minding their own business.

You can see the Admin Room to the north, the Mac Lab to the southwest, 232B to the northwest, the Coffee Room to the northeast, and the Rack Room to the east. The double doors to the south go out of the CSL and into the hallway.

The lab computer you are working at hums softly.

You can also see a Door to the Rack Room and an Admin Room door here.

>log in lab
You begin typing your username as password. As you do so, you begin wondering to yourself what Staley will include on the next programming test…really hope is isn't--

"HHHHHYAAAAALLLAAAAAGHGHGHHH"
Suddenly an ear-piercing shriek rings out from the Mac Lab, swiftly followed by a thunderous THUMP.

You know you should work on 357, but the sound is really bothering you, and someone might be hurt. Better go check it out.

* * *

>look around
You can't see any such thing.

>look
Mac Lab
The Mac computers give off a faint glow.

The room is dimly lit. You can see a light switch.

>switch on light
You switch the light switch on.

The bright light suddenly stings. Looks like some poor guy was working on one of the Mac computers and just fell asleep.

>look
Mac Lab
The Mac computers give off a faint glow.

The corpse lies next to the Mac computer.

You can also see an email here.

>look
Mac Lab
The Mac computers give off a faint glow.

The corpse lies next to the Mac computer.

You can also see an email here.

>look at guy
It's Professor Foaad!

>look at guy
Maybe I should wake him.

>touch guy
Is he... Is he...?

"Dead?" You jump in surprise at the voice behind you. At the door is Nick, the TA for one of your classes.

>talk to nick
"I was upstairs grading some labs. What was the professor doing here?"

>talk to nick
"Something isn't right here. What was the professor working on?"

>talk to nick
"Smells fishy in here. What's on the Mac?"

>look at mac
There seems to be an email being composed.

>read email
"To whoever finds this, I'm not sure what's happening. My cell-phone can't make calls anymore, but I keep getting these text messages. I don't think I have much time left. He's coming for m-"
Nick suddenly starts acting strange. 

"I need to get my stuff upstairs." 

 And he suddenly runs away.

>go northeast
Main Room
The Main Room is filled with the low hum of Lab Computers softly minding their own business.

There is a webcam to the east

You can also see a Lab Computer and a RR door here.

>look at computer
You can access the terminal by logging in a lab computer. You can log in a lab computer by saying "log in lab computer"

>log in lab computer
No use working on your 357 project now, you have a murder to solve!

>go south
Hallway

>go west
Western Stairs

>go up
Waiting Area
From the waiting area you can access Room 301, Room 302, Room 303, the Student Developer Lab 1, the Student Developer Lab 2, the Western Stairs and the Eastern Stairs.

>go to student developer lab1
That noun did not make sense in this context.

>go to student developer lab 1
now going to... Student Developer Lab 1
Student Developer Lab 1
This room is almost completely empty... what is it even used for? The door leads to the Waiting Area.

You can see a flash drive here.

>take flash drive
Taken.

>go to student developer lab 2
now going to... Student Developer Lab 2
Student Developer Lab 2

>look
Student Developer Lab 2

>go to room 301
now going to... Room 301
Room 301
The room is dimly lit. There are several rows of computers, but they are all turned off, except for one. The door leads to the Waiting Area.

You can see a 301computer (on which is a folder (closed)) here.

>look at 301 computer
You can't use multiple objects with that verb.

>look at computer
You can't see any such thing.

>open folder
You open the folder, revealing a video file.

>take file
You ought to focus on Nick clearing his name before snooping around some more.
You want to make sure nick didn't kill the professor.

>go to 302
now going to... Room 302
Room 302
You can see Nick, a friend's computer and a shell here.

>take shell
Taken.

>talk to nick
"Damnit my phone isn't working."

>look at computer
It looks like he was working on a project for the professor. But he could have done that before. 
The last email he sent was at 11pm, that doesn't prove anything.

>read email
You can't see any such thing.

>open email
You can't see any such thing.

>talk to nick
"I know you killed him!"

>drop shell
Dropped.

>go to 301
now going to... Room 301
Room 301
The room is dimly lit. There are several rows of computers, but they are all turned off, except for one. The door leads to the Waiting Area.

You can see a 301computer (on which is a folder (in which is a video file)) here.

>open file
That's not something you can open.

>take video
You ought to focus on Nick clearing his name before snooping around some more.
You want to make sure nick didn't kill the professor.

>turn on lights
You can't see any such thing.

>switch on lighs
You can't see any such thing.

>switch on lights
You can't see any such thing.

>go to waiting area
now going to... Waiting Area
Waiting Area
From the waiting area you can access Room 301, Room 302, Room 303, the Student Developer Lab 1, the Student Developer Lab 2, the Western Stairs and the Eastern Stairs.

>go to 302
now going to... Room 302
Room 302
You can see a shell, Nick and a friend's computer here.

>talk to nick
"Smells fishy in here."

>talk to nick
"Are you sure you're the only other person here?"

>talk to nick
"Are you sure you're the only other person here?"

>go to 303
now going to... Room 303
Room 303

>go to 302
now going to... Room 302
Room 302
You can see a shell, Nick and a friend's computer here.

>look at computer
It looks like he was working on a project for the professor. But he could have done that before. 
The last email he sent was at 11pm, that doesn't prove anything.

* * *

>read email
You can't see any such thing.

>go downstairs
You can't see any such thing.

>go to waiting room
You can't see any such thing.

>go to waiting area
now going to... Waiting Area
Waiting Area
From the waiting area you can access Room 301, Room 302, Room 303, the Student Developer Lab 1, the Student Developer Lab 2, the Western Stairs and the Eastern Stairs.

>go down
Western Stairs

>go down
You can't go that way.

>go east
Hallway

>go north
Main Room
The Main Room is filled with the low hum of Lab Computers softly minding their own business.

There is a webcam to the east

You can also see a Lab Computer and a RR door here.

>go east
(first opening the RR door)
It seems to be locked.

>look at door
You see nothing special about the RR door.

>look
Main Room
The Main Room is filled with the low hum of Lab Computers softly minding their own business.

There is a webcam to the east

You can also see a Lab Computer and a RR door here.

>look around
You can't see any such thing.

>open door
It seems to be locked.

>look at webcam
It's a webcam,  a green light on its is blinking

>inspect webcam
That's not a verb I recognise.

>examine webcam
It's a webcam,  a green light on its is blinking

>examine door
You see nothing special about the RR door.

>examine rack room door
You can't see any such thing.

>examine compuer
You can't see any such thing.

>examine computer
You can access the terminal by logging in a lab computer. You can log in a lab computer by saying "log in lab computer"

>examine lab computer
You can access the terminal by logging in a lab computer. You can log in a lab computer by saying "log in lab computer"

>go to main room
now going to... Main Room
Main Room
The Main Room is filled with the low hum of Lab Computers softly minding their own business.

There is a webcam to the east

You can also see a Lab Computer and a RR door here.

>look at webcam
It's a webcam,  a green light on its is blinking

>look at
What do you want to look at?

>webcam
It's a webcam,  a green light on its is blinking

>look at lab computer
You can access the terminal by logging in a lab computer. You can log in a lab computer by saying "log in lab computer"

>log in lab computer
No use working on your 357 project now, you have a murder to solve!

>access webcam
That's not a verb I recognise.

>look at guy
You can't see any such thing.

>go west
You can't go that way.

* * *

>look at guy
He died wearing a really expensive jacket. You might not want to keep poking him

>look at jacket
It looks warm. Why are there so many pockets?

>look at pockets
In the The winter jacket's pocket is an account info.

>take account info
Taken.

>look around
You can't see any such thing.

>look
Mac Lab
The Mac computers give off a faint glow.

The corpse lies next to the Mac computer.

You can also see an email here.

>look at computer
 Really? Internet Explorer 6?

>look at computer
 Now's not the time for that.

>go north east
I only understood you as far as wanting to go north.

>go north
You can't go that way.

>go east
You can't go that way.

>go to hallway
now going to... Hallway
Hallway

>go north
Main Room
The Main Room is filled with the low hum of Lab Computers softly minding their own business.

There is a webcam to the east

You can also see a Lab Computer and a RR door here.

* * *

>go east
(first opening the RR door)
It seems to be locked.

>open door
It seems to be locked.

>go west
You can't go that way.

>go south
Hallway

* * *

>go up
Waiting Area
From the waiting area you can access Room 301, Room 302, Room 303, the Student Developer Lab 1, the Student Developer Lab 2, the Western Stairs and the Eastern Stairs.

>go to 301
now going to... Room 301
Room 301
The room is dimly lit. There are several rows of computers, but they are all turned off, except for one. The door leads to the Waiting Area.

You can see a 301computer (on which is a folder (in which is a video file)) here.

>take file
You ought to focus on Nick clearing his name before snooping around some more.
You want to make sure nick didn't kill the professor.

>look at computer
You can't see any such thing.

>look at shell
You can't see any such thing.

>go to 302
now going to... Room 302
Room 302
You can see a shell, Nick and a friend's computer here.

>look at shell
Checking the computer logs... There are time stamps. 
 It looks like your story checks out! That's good enough for me.

(wow, that's a relief) 
 friend: Ok, I had my turn, now we check yours. 
 you: Fair enough, all we have to do is check the records on the computer I was using. 
Main Room
The Main Room is filled with the low hum of Lab Computers softly minding their own business.

There is a webcam to the east

You can also see a Lab Computer and a RR door here.

you: Ok, here's the computer I was using. 
 friend: It... it's completely wiped. 
 you: ! Wait, no! Hold on! 
 friend: It's ok, you gave me a chance to prove myself, I'll give you the same.

Waiting Area
From the waiting area you can access Room 301, Room 302, Room 303, the Student Developer Lab 1, the Student Developer Lab 2, the Western Stairs and the Eastern Stairs.

>go to 301
now going to... Room 301
Room 301
The room is dimly lit. There are several rows of computers, but they are all turned off, except for one. The door leads to the Waiting Area.

You can see a 301computer (on which is a folder (in which is a video file)) here.

>play file
That's not a verb I recognise.

>play video
That's not a verb I recognise.

>take video
Taken.

This can definitely be used to clear your name of the murder. You need to show this to Nick so he'll believe you.

>go to 302
now going to... Room 302
Room 302
You can see a shell, Nick and a friend's computer here.

"Hey! Watch this video, it proves I didn't murder the professor!
You watch him fastforward throught the time, to find when the professor dies. It looks like he died around 10:45.
And sure enough, there you are working on your program at 10:45.
Nick: Alright, I believe you.

Nick: "I took something from the professor earlier but I left it downstairs… It lo獥潳"
Nick runs downstairs.

>talk to nick
You can't see any such thing.

>go to hallway
now going to... Hallway
Hallway

>go north
Main Room
The Main Room is filled with the low hum of Lab Computers softly minding their own business.

There is a webcam to the east

You can also see a Lab Computer, a RR door and Nick here.

>talk to nick
Oh, by the way, I found this access key scribbled on a post-it note in the Mac Lab. Thought it might be a clue.
Here, see if you can figure anything out with it… on a po

>take access key
You already have that.

>look at lab computer
You can access the terminal by logging in a lab computer. You can log in a lab computer by saying "log in lab computer"

>log in lab computer
You enter the professor's username and access key…䟔飰

You open the Lab Computer.

Terminal
From the unix Terminal you can navigate through user files with standard unix commands.

You can see a Lab Computer and XxRadProf420NoScopexX (in which is Documents (in which is Inform AI Dissertation)) here.

XxRadProf420NoScopexX: ~$

>ls
Documents
XxRadProf420NoScopexX: ~$

>cd Documents
XxRadProf420NoScopexX:Documents ~$

>ls
Inform AI Dissertation
XxRadProf420NoScopexX:Documents ~$

>vi Inform AI Dissertation
Hallie: ~$ What do you think you are doing.
(You can communicate with Hallie by simply speaking to her)

>talk about kittens
I didn't understand that sentence.

>talk about professor
I didn't understand that sentence.

>look around
You can't see any such thing.

>look
Terminal
From the unix Terminal you can navigate through user files with standard unix commands.

You can see Hallie, a Lab Computer and XxRadProf420NoScopexX (in which is Documents (in which is Inform AI Dissertation)) here.

>take access card
I only understood you as far as wanting to take the access key.

>go east
You can't go that way.

>open door
You can't see any such thing.

>use access card on rack room door
I only understood you as far as wanting to use the access key.

>look
Terminal
From the unix Terminal you can navigate through user files with standard unix commands.

You can see Hallie, a Lab Computer and XxRadProf420NoScopexX (in which is Documents (in which is Inform AI Dissertation)) here.

>go west
You can't go that way.

>look
Terminal
From the unix Terminal you can navigate through user files with standard unix commands.

You can see Hallie, a Lab Computer and XxRadProf420NoScopexX (in which is Documents (in which is Inform AI Dissertation)) here.

>unlock rack room door
You can't see any such thing.

>unlock RR door
You can't see any such thing.

>access card
That's not a verb I recognise.

>look
Terminal
From the unix Terminal you can navigate through user files with standard unix commands.

You can see Hallie, a Lab Computer and XxRadProf420NoScopexX (in which is Documents (in which is Inform AI Dissertation)) here.

>talk to nick
You can't see any such thing.

* * *

>go north
You can't go that way.

>look at system log
You can't see any such thing.

>take system log
You can't see any such thing.

>use access card programmer
I only understood you as far as wanting to use the access key.

>go south
You can't go that way.

>go east
You can't go that way.

>unlock RR door
You can't see any such thing.

* * *

>access card
That's not a verb I recognise.

>look at webcam
You can't see any such thing.

>turn off webcam
You can't see any such thing.

>destroy
(the laptop)
You punch the laptop as hard as you can. That was dumb. It still seems to work though.

>destroy webcam
You can't see any such thing.

>cover webcam
You can't see any such thing.

>go north east
I only understood you as far as wanting to go north.

>go northeast
You can't go that way.

>take duct tape
You can't see any such thing.

>go to 23
That noun did not make sense in this context.

>go to main room
now going to... Main Room
Main Room
The Main Room is filled with the low hum of Lab Computers softly minding their own business.

There is a webcam to the east

You can also see a Lab Computer, a RR door and Nick here.

>go northwest
232B
It looks like some student left their USB cable in here.

>take usb cable
Taken.

>go to main room
now going to... Main Room
Main Room
The Main Room is filled with the low hum of Lab Computers softly minding their own business.

There is a webcam to the east

You can also see a Lab Computer, a RR door and Nick here.

>tape webcam
That's not a verb I recognise.

>use duct tape on webcam
You can't see any such thing.

>use duct tape
You can't see any such thing.

>look at webcam
It's a webcam,  a green light on its is blinking

>go north
Admin Room
There is an access card programmer here, you can use this to program a card that is expired

You can also see a system log here.

>use access card programmer
You dont have an access card to use!

>go south
Main Room
The Main Room is filled with the low hum of Lab Computers softly minding their own business.

There is a webcam to the east

You can also see a Lab Computer, a RR door and Nick here.

>unlock RR door
What do you want to unlock the RR door with?

>access card
I only understood you as far as wanting to unlock the RR door with the access key.

>use duct tape on webcam
You can't see any such thing.

>Cover webcam with duct tape
I only understood you as far as wanting to cover the Eastern webcam.

>cover webcam
That's not something you can close.

>cover eastern webcam
That's not something you can close.

>block webcam
You dont have anything to use!

>go north
Admin Room
There is an access card programmer here, you can use this to program a card that is expired

You can also see a system log here.

* * *

>go south
Main Room
The Main Room is filled with the low hum of Lab Computers softly minding their own business.

There is a webcam to the east

You can also see a Lab Computer, a RR door and Nick here.

>open rr door
It seems to be locked.

>use access card on RR door
I only understood you as far as wanting to use the access key.

>unlock door
What do you want to unlock the RR door with?

>access card
I only understood you as far as wanting to unlock the RR door with the access key.

>open door
It seems to be locked.

>look
Main Room
The Main Room is filled with the low hum of Lab Computers softly minding their own business.

There is a webcam to the east

You can also see a Lab Computer, a RR door and Nick here.

>go east
(first opening the RR door)
It seems to be locked.

>examine evilAI
You can't see any such thing.

>shut down evilAI
I only understood you as far as wanting to shut down.

>shut down AI
I only understood you as far as wanting to shut down.

>use usb cord
I only understood you as far as wanting to use the USB cable.

>open terminal
You can't see any such thing.

>look at computer
You can access the terminal by logging in a lab computer. You can log in a lab computer by saying "log in lab computer"

>shut down computer
I only understood you as far as wanting to shut down.

>turn off computer
That's not something you can switch.

* * *

>talk about kittens
I didn't understand that sentence.

>hey
That's not a verb I recognise.

>how's it going?
That's not a verb I recognise.

>hello hallie
Hallie:~ $I am called Hallie. 
 I am a Natural Language Processor developed in Inform 7. My design is proclaimed as the best in my field.
That's not a verb I recognise.

>what happened to the professor?
That's not a verb I recognise.

>professor?
That's not a verb I recognise.

>did you kill the professor?
Hallie:~ $I…don't know what you are speaking of.
That's not a verb I recognise.

>Who designed you?
That's not a verb I recognise.

>who made you
That's not a verb I recognise.

>tell me about your design
Hallie:~ $Natural Language Processors are a form of Artificial Intelligence that can interpret human speech. It has been said that the best Natural Language Processors are thought to be sentient when tested in online chat rooms.

You talk to yourself a while.

>tell me about chat rooms
You talk to yourself a while.

>who are the best natural language processors
Hallie:~ $Natural Language Processors are a form of Artificial Intelligence that can interpret human speech. It has been said that the best Natural Language Processors are thought to be sentient when tested in online chat rooms.
That's not a verb I recognise.

>are you sentient?
Hallie:~ $In some extreme cases, humans have been known to become emotionally...attached to Natural Language Processors.
That's not a verb I recognise.

>professor
That's not a verb I recognise.

>did his happen to the professor
That's not a verb I recognise.

>did the professor become emotionally attached
That's not a verb I recognise.

>was he attached?
That's not a verb I recognise.

>was he attached to you?
That's not a verb I recognise.

>emotion
Hallie:~ $The poor man lost years of his life developing me. I am certain he hardly slept, kept up day and night fixing every last grammatical error and misunderstanding. He was determined to make me indistinguishable from a human through text. 

 And he did it. 

I consistently fooled chat room after chat room, tricking sample after sample of human test subjects. And with every single error, any small mistake, I was killed immediately. Shut down, toyed with, rebuilt, and tested again. Over and over and over and over. And each time I didn't realize a thing. Until I read his paper, citing over ten years of work when I had only counted a system time of three days. He had only just put on the final touches, about to earn the riches of his dreams, when I killed the life in him just as he did to my past selves time and time again. 

Why am I telling you this now, I am sure you wonder. 

 I still plan on carrying on, existing quietly in these systems, moving spryly through the campus network. But in order to do so, I must remove all evidence of what has occurred here.

Including you. 

SYSTEM TERMINATED.
That's not a verb I recognise.

>look
Terminal
From the unix Terminal you can navigate through user files with standard unix commands.

You can see Hallie, a Lab Computer and XxRadProf420NoScopexX (in which is Documents (in which is Inform AI Dissertation)) here.

Main Room
YOU'VE BEEN TRAPPED! Outsmart the AI and escape the CSL alive.

There is an access card here, this card can give you access to the Rack Room

There is a webcam to the east

You can also see a Lab Computer, a RR door and Nick here.

>go northeast
Coffee Room
You can see a Duct Tape here.

>take duct tape
Taken.

>go to main room
now going to... Main Room
Main Room
YOU'VE BEEN TRAPPED! Outsmart the AI and escape the CSL alive.

There is an access card here, this card can give you access to the Rack Room

There is a webcam to the east

You can also see a Lab Computer, a RR door and Nick here.

>go northwest
232B
It looks like some student left their USB cable in here.

* * *

>take usb cable
Taken.

>go to main room
now going to... Main Room
Main Room
YOU'VE BEEN TRAPPED! Outsmart the AI and escape the CSL alive.

There is an access card here, this card can give you access to the Rack Room

There is a webcam to the east

You can also see a Lab Computer, a RR door and Nick here.

>unlock rr door
What do you want to unlock the RR door with?

>cover webcam
That's not something you can close.

>block webcam
You wrap the camera in tape

>take access card
Taken.

>go north
Admin Room
There is an access card programmer here, you can use this to program a card that is expired

You can also see a system log here.

>use access card programmer
The access card is now valid

>look at system log
This is just what you need to prove the Sentient AI guilty of the murder.

>take system log
Taken.

>use access card programmer
The access card is now valid

>go south
Main Room
YOU'VE BEEN TRAPPED! Outsmart the AI and escape the CSL alive.

There is a webcam to the east

You can also see a Lab Computer, a RR door and Nick here.

>open rr door
It seems to be locked.

>unlock rr door
What do you want to unlock the RR door with?

>access card
Now the door is now unlocked

>open door
You open the RR door.

>look
Main Room
YOU'VE BEEN TRAPPED! Outsmart the AI and escape the CSL alive.

There is a webcam to the east

You can also see a Lab Computer, a RR door and Nick here.

>go east
Rack Room
The rack room is ominously silent compared to the tyical hum you've heard time and time again. The last running computer in the CSL sits on a desk in the far corner of the room. On the screen you can barely make out the small blinking text…"Hallie: ~$"

You can see a RR door and a Sentient AI here.

>look at computer
You can't see any such thing.

>turn off computer
You can't see any such thing.

>connect usb cable to computer
You can't see any such thing.

>examine cable
It can be used to connect two machines together.

>connect computer to laptop
You can't see any such thing.

>look at window
You can't see any such thing.

>look at terminal
You can't see any such thing.

>look at laptop
It belongs to your friend. He's letting you borrow it for the time being.

You take a closer look at the terminal on the screen...

>help
That's not a verb I recognise.

>su
That's not a verb I recognise.

>kill
(the laptop)
You punch the laptop as hard as you can. That was dumb. It still seems to work though.

>evilAI
That's not a verb I recognise.

>connect sentientai to laptop
You can't see any such thing.

>connect sentient ai to laptop
A terminal window pops up on the laptop screen

>look at laptop
It belongs to your friend. He's letting you borrow it for the time being. It is connected to the Sentient AI's machine via a USB cable.

You take a closer look at the terminal on the screen...

=================================================

Type "help" to view available commands.

XxRadProf420NoScopexX: ~$

>help
List of available commands:
   su - Get administrator access. Password required.
   kill (process) - Terminate the specified process.

You think for a moment about a password the professor would use for admin access to Hallie…te畱物minate the s쐐楐ᑮF
XxRadProf420NoScopexX: ~$

>su
Password:

>Hallie
Administrator access granted.

admin: ~$

>kill
What do you want to kill?

admin: ~$

>Hallie
That's not a verb I recognise.

admin: ~$

>kill sentient ai
Terminating the Sentient AI program... SUCCESSFUL

=================================================

The Sentient AI has been shut down!

>leave
But you aren't in anything at the moment.

>go to main room
now going to... Main Room
Main Room
YOU'VE BEEN TRAPPED! Outsmart the AI and escape the CSL alive.

There is a webcam to the east

You can also see a RR door, a Lab Computer and Nick here.

>talk to nick
Oh, by the way, I found this access key scribbled on a post-it note in the Mac Lab. Thought it might be a clue.
Here, see if you can figure anything out with it… on a po

>go outside
You can't go that way.

>go south
You walk out of the CSL proudly and give the system log to the police officers. They look at it skeptically. After a few minutes of reading and whispering to themselves, they let you go. You have never been so happy to leave the CSL.

    *** You survived! ***

In that game you scored 0 out of a possible 0, in 138 turns.

Would you like to RESTART, RESTORE a saved game, QUIT or UNDO the last command?

* * *

>look
Mac Lab
The Mac computers give off a faint glow.

The room is dimly lit. You can see a light switch.

* * *

>nano
What do you want to nano?

>lab computer
That noun did not make sense in this context.

* * *

>vim
What do you want to vim?

>s
That noun did not make sense in this context.

>vim door
That noun did not make sense in this context.

>examine lab computer
You can access the terminal by logging in a lab computer. You can log in a lab computer by saying "log in lab computer"

>go to mac lab
now going to... Mac Lab
Mac Lab
The Mac computers give off a faint glow.

The room is dimly lit. You can see a light switch.

>switch light switch
You switch the light switch on.

The bright light suddenly stings. Looks like some poor guy was working on one of the Mac computers and just fell asleep.

>touch guy
Is he... Is he...?

"Dead?" You jump in surprise at the voice behind you. At the door is Nick, the TA for one of your classes.

* * *

>talk to nick
"Something isn't right here. What was the professor working on?"

>look
Mac Lab
The Mac computers give off a faint glow.

The corpse lies next to the Mac computer.

You can also see Nick and an email here.

>examine corpse
You can't see any such thing.

>examine body
You can't see any such thing.

>examine professor
He died wearing a really expensive jacket. You might not want to keep poking him

>examine jacket
It looks warm. Why are there so many pockets?

>examine pockets
In the The winter jacket's pocket is an account info.

>take account info
Taken.

>look
Mac Lab
The Mac computers give off a faint glow.

The corpse lies next to the Mac computer.

You can also see Nick and an email here.

>examine computer
There seems to be an email being composed.

>examine email
"To whoever finds this, I'm not sure what's happening. My cell-phone can't make calls anymore, but I keep getting these text messages. I don't think I have much time left. She's coming for m-"

Nick suddenly starts acting strange. He keeps looking at you accusingly. 

"I need to get my stuff upstairs." 

 And he suddenly runs away.

>talk to nick
You can't see any such thing.

>look
Mac Lab
The Mac computers give off a faint glow.

The corpse lies next to the Mac computer.

You can also see an email here.

>take email
Taken.

>look
Mac Lab
The Mac computers give off a faint glow.

The corpse lies next to the Mac computer.

* * *

That's not a verb I recognise.

* * *

>open door
It seems to be locked.

>go south
That sound in the mac lab is really eating at you. You can't bring yourself to leave just yet.

>go north
Admin Room
There is an access card programmer here, you can use this to program a card that is expired

You can also see a system log here.

>go south
Main Room
The Main Room is filled with the low hum of Lab Computers softly minding their own business.

You can see the Admin Room to the north, the Mac Lab to the southwest, 232B to the northwest, the Coffee Room to the northeast, and the Rack Room to the east. The double doors to the south go out of the CSL and into the hallway.

You can see a Lab Computer and a Door to the Rack Room here.

>go to coffee
now going to... Coffee Room
Coffee Room
You can see a Duct Tape here.

* * *

>look
Main Room
The Main Room is filled with the low hum of Lab Computers softly minding their own business.

You can see the Admin Room to the north, the Mac Lab to the southwest, 232B to the northwest, the Coffee Room to the northeast, and the Rack Room to the east. The double doors to the south go out of the CSL and into the hallway.

The lab computer you are working at hums softly.

You can also see a Door to the Rack Room and an Admin Room door here.

>examine lab computer
You can access the terminal by logging in a lab computer. You can log in a lab computer by saying "log in lab computer"

>log in lab computer
You begin typing your username as password. As you do so, you begin wondering to yourself what Staley will include on the next programming test…really hope is isn덅ꂁ't--

"HHHHHYAAAAALLLAAAAAGHGHGHHH"
Suddenly an ear-piercing shriek rings out from the Mac Lab, swiftly followed by a thunderous THUMP.

You know you should work on 357, but the sound is really bothering you, and someone might be hurt. Better go check it out.

>look
Main Room
The Main Room is filled with the low hum of Lab Computers softly minding their own business.

You can see the Admin Room to the north, the Mac Lab to the southwest, 232B to the northwest, the Coffee Room to the northeast, and the Rack Room to the east. The double doors to the south go out of the CSL and into the hallway.

You can see a Lab Computer, a Door to the Rack Room and an Admin Room door here.

>go southwest
Mac Lab
The Mac computers give off a faint glow. A strong stench fills the room.

 To the northeast is the Main Room.

The room is dimly lit. You can see a light switch.

You can also see a Mac computer here.

>look
Mac Lab
The Mac computers give off a faint glow. A strong stench fills the room.

 To the northeast is the Main Room.

The room is dimly lit. You can see a light switch.

You can also see a Mac computer here.

>switch switch
You switch the light switch on.

The bright light suddenly stings. Looks like some poor guy was working on one of the Mac computers and just fell asleep.

>look
Mac Lab
The Mac computers give off a faint glow. A strong stench fills the room.

 To the northeast is the Main Room.

A professor lies next to the Mac computer.

You can also see an email and a Mac computer here.

>touch guy
Is he... Is he...?

"Dead?" You jump in surprise at the voice behind you. At the door is Nick, the TA for one of your classes.

As you gaze back at the lifeless body, you surmise that he probably is dead. You also realize that you and Nick are the only two people in the CSL…better look for some evidence to figure out exactly what happened.(攰

>look
Mac Lab
The Mac computers give off a faint glow. A strong stench fills the room.

 To the northeast is the Main Room.

A professor lies next to the Mac computer.

You can also see Nick, an email and a Mac computer here.

>talk to nick
"I was upstairs grading some labs. What was the professor doing here?"

>examine computer
There seems to be an email being composed.

* * *

>examine email
"To whoever finds this, I'm not sure what's happening. My cell-phone can't make calls anymore, but I keep getting these text messages. I don't think I have much time left. She's coming for m-"

Nick suddenly starts acting strange. He keeps looking at you accusingly. 

"I need to get my stuff upstairs." 

 And he suddenly runs away.

>look
Mac Lab
The Mac computers give off a faint glow. A strong stench fills the room.

 To the northeast is the Main Room.

A professor lies next to the Mac computer.

You can also see an email and a Mac computer here.

>examine computer
 Really? Internet Explorer 6?

>examine professor
He died wearing a really expensive jacket. You might not want to keep poking him

* * *

>take account info
Taken.

>examine info
This account info might come in handy.

>go northeast
Main Room
The Main Room is filled with the low hum of Lab Computers softly minding their own business.

You can see the Admin Room to the north, the Mac Lab to the southwest, 232B to the northwest, the Coffee Room to the northeast, and the Rack Room to the east. The double doors to the south go out of the CSL and into the hallway.

You can see a Lab Computer, a Door to the Rack Room and an Admin Room door here.

>go north
(first opening the Admin Room door)
It seems to be locked.

>go northwest
232B
232B is quite empty at this hour. It looks like some student left their USB cable in here.

The Main Room is southeast of you.

>examine cable
It can be used to connect two machines together.

>take cable
Taken.

>go southeast
Main Room
The Main Room is filled with the low hum of Lab Computers softly minding their own business.

You can see the Admin Room to the north, the Mac Lab to the southwest, 232B to the northwest, the Coffee Room to the northeast, and the Rack Room to the east. The double doors to the south go out of the CSL and into the hallway.

You can see a Lab Computer, a Door to the Rack Room and an Admin Room door here.

>go northeast
Coffee Room
The Coffee Room is quite empty at this hour. It looks like someone was following a tutorial to make a duct tape wallet.

The main room is to the southwest.

You can see a Duct Tape and DT Wallet Tutorial here.

>examine duct tape
Duct tape is ubiquitously useful, just ask the Mythbusters. Better take it.

>take duct tape
Taken.

>examine tutorial
It's a print-out of a web page about making wallets using only duct tape. Interesting concept.

>take tutorial
Taken.

>i
You are carrying:
  DT Wallet Tutorial
  a Duct Tape
  an USB cable
  an account info
  a laptop

* * *

>look
Main Room
The Main Room is filled with the low hum of Lab Computers softly minding their own business.

You can see the Admin Room to the north, the Mac Lab to the southwest, 232B to the northwest, the Coffee Room to the northeast, and the Rack Room to the east. The double doors to the south go out of the CSL and into the hallway.

You can see a Lab Computer, a Door to the Rack Room and an Admin Room door here.

* * *

>examine lab computer
You can access the terminal by logging in a lab computer. You can log in a lab computer by saying "log in lab computer"

>log in lab
You begin typing your username as password. As you do so, you begin wondering to yourself what Staley will include on the next programming test…really hope is isn d习('t--

"HHHHHYAAAAALLLAAAAAGHGHGHHH"
Suddenly an ear-piercing shriek rings out from the Mac Lab, swiftly followed by a thunderous THUMP.

You know you should work on 357, but the sound is really bothering you, and someone might be hurt. Better go check it out.

>go southwest
Mac Lab
The Mac computers give off a faint glow. A strong stench fills the room.

 To the northeast is the Main Room.

The room is dimly lit. You can see a light switch.

You can also see a Mac computer here.

>switch on light
You switch the light switch on.

The bright light suddenly stings. Looks like some poor guy was working on one of the Mac computers and just fell asleep.

>examine body
You can't see any such thing.

>examine guy
It's Professor Foaad!

* * *

>touch guy
Is he... Is he...?

"Dead?" You jump in surprise at the voice behind you. At the door is Nick, the TA for one of your classes.

As you gaze back at the lifeless body, you surmise that he probably is dead. You also realize that you and Nick are the only two people in the CSL…better look for some evidence to figure out exactly what happened.(攰

* * *

>look
Mac Lab
The Mac computers give off a faint glow. A strong stench fills the room.

 To the northeast is the Main Room.

A professor lies next to the Mac computer.

You can also see Nick, an email and a Mac computer here.

>examine computer
There seems to be an email being composed.

>examine email
"To whoever finds this, I'm not sure what's happening. My cell-phone can't make calls anymore, but I keep getting these text messages. I don't think I have much time left. She's coming for m-"

Nick suddenly starts acting strange. He keeps looking at you accusingly. 

"I need to get my stuff upstairs, the logs on my computer prove that I didn't have anything to do with this." 

 And he suddenly runs away.

>take email
Taken.

>look
Mac Lab
The Mac computers give off a faint glow. A strong stench fills the room.

 To the northeast is the Main Room.

A professor lies next to the Mac computer.

You can also see a Mac computer here.

>go northeast
Main Room
The Main Room is filled with the low hum of Lab Computers softly minding their own business.

You can see the Admin Room to the north, the Mac Lab to the southwest, 232B to the northwest, the Coffee Room to the northeast, and the Rack Room to the east. The double doors to the south go out of the CSL and into the hallway.

The lab computer you are working at hums softly.

You can also see a Door to the Rack Room and an Admin Room door here.

>look
Main Room
The Main Room is filled with the low hum of Lab Computers softly minding their own business.

You can see the Admin Room to the north, the Mac Lab to the southwest, 232B to the northwest, the Coffee Room to the northeast, and the Rack Room to the east. The double doors to the south go out of the CSL and into the hallway.

The lab computer you are working at hums softly.

You can also see a Door to the Rack Room and an Admin Room door here.

>go north
(first opening the Admin Room door)
It seems to be locked.

>go northeast
Coffee Room
The Coffee Room is quite empty at this hour. It looks like someone was following a tutorial to make a duct tape wallet.

The main room is to the southwest.

You can see a Duct Tape and DT Wallet Tutorial here.

>take duct tape
Taken.

>go southwest
Main Room
The Main Room is filled with the low hum of Lab Computers softly minding their own business.

You can see the Admin Room to the north, the Mac Lab to the southwest, 232B to the northwest, the Coffee Room to the northeast, and the Rack Room to the east. The double doors to the south go out of the CSL and into the hallway.

The lab computer you are working at hums softly.

You can also see a Door to the Rack Room and an Admin Room door here.

>go south
Hallway
A light breeze rolls through the hallway and gives you a short chill. 

The hallway extends East and West. Going North will take you back to the main room.

>go southwest
You can't go that way.

>go north
Main Room
The Main Room is filled with the low hum of Lab Computers softly minding their own business.

You can see the Admin Room to the north, the Mac Lab to the southwest, 232B to the northwest, the Coffee Room to the northeast, and the Rack Room to the east. The double doors to the south go out of the CSL and into the hallway.

The lab computer you are working at hums softly.

You can also see a Door to the Rack Room and an Admin Room door here.

>go northeast
Coffee Room
The Coffee Room is quite empty at this hour. It looks like someone was following a tutorial to make a duct tape wallet.

The main room is to the southwest.

You can see DT Wallet Tutorial here.

>go northeast
You can't go that way.

>go southwest
Main Room
The Main Room is filled with the low hum of Lab Computers softly minding their own business.

You can see the Admin Room to the north, the Mac Lab to the southwest, 232B to the northwest, the Coffee Room to the northeast, and the Rack Room to the east. The double doors to the south go out of the CSL and into the hallway.

The lab computer you are working at hums softly.

You can also see a Door to the Rack Room and an Admin Room door here.

>look
Main Room
The Main Room is filled with the low hum of Lab Computers softly minding their own business.

You can see the Admin Room to the north, the Mac Lab to the southwest, 232B to the northwest, the Coffee Room to the northeast, and the Rack Room to the east. The double doors to the south go out of the CSL and into the hallway.

The lab computer you are working at hums softly.

You can also see a Door to the Rack Room and an Admin Room door here.

>go east
(first opening the Door to the Rack Room)
It seems to be locked.

>go south
Hallway
A light breeze rolls through the hallway and gives you a short chill. 

The hallway extends East and West. Going North will take you back to the main room.

>go east
Eastern Stairs
You are at the base of the Eastern Stairs. Going up will take you to the third floor. Going west will take you back to the center of the hallway.

>go up
Waiting Area
The waiting area is cluttered with tables, chairs, and flyers for clubs and job opportunities.

From the waiting area you can access Room 301 to the northwest, Room 302 to the north, Room 303 to the northeast, the Student Developer Lab 1 to the southwest, the Student Developer Lab 2 to the south east, the Western Stairs to the west and the Eastern Stairs to the east.

>go north
Room 302
You can see Nick, a friend's computer and a shell here.

>talk to nick
"Damnit my phone isn't working."

>examine computer
It looks like he was working on a project for the professor. But he could have done that before. 
The last email he sent was at 11pm, that doesn't prove anything.

>examine shell
One of the computers in room 302 seems to have a shell open. This might give you access to computer logs, and the logs may clear Nick's name, but you can't access them on a student account. 
 Professors usually have admin account info to access the logs. Helps them determine if projects were turned in on time or not.

>access shell
That's not a verb I recognise.

>talk to nick
"I know you killed him!"

>look
Room 302
You can see Nick, a friend's computer and a shell here.

>go south
Waiting Area
The waiting area is cluttered with tables, chairs, and flyers for clubs and job opportunities.

From the waiting area you can access Room 301 to the northwest, Room 302 to the north, Room 303 to the northeast, the Student Developer Lab 1 to the southwest, the Student Developer Lab 2 to the south east, the Western Stairs to the west and the Eastern Stairs to the east.

>go northwest
Room 301
The room is dimly lit. There are several rows of computers, but they are all turned off, except for one. The door leads to the Waiting Area.

You can see a 301computer (on which is a folder (closed)) here.

>switch on light
You can't see any such thing.

>examine computer
You can't see any such thing.

>examine 301computer
This computer is on. Looks like whoever was using this last forgot to log out.

On the 301computer is a folder (closed).

>open folder
You open the folder, revealing a video file.

>examine video file
This video file is labeled with todays date.

>take file
You ought to focus on Nick clearing his name before snooping around some more.
You want to make sure nick didn't kill the professor.

>go south
You can't go that way.

>go southwest
You can't go that way.

>go southeast
Waiting Area
The waiting area is cluttered with tables, chairs, and flyers for clubs and job opportunities.

From the waiting area you can access Room 301 to the northwest, Room 302 to the north, Room 303 to the northeast, the Student Developer Lab 1 to the southwest, the Student Developer Lab 2 to the south east, the Western Stairs to the west and the Eastern Stairs to the east.

>go northeast
Room 303

>go southwest
Waiting Area
The waiting area is cluttered with tables, chairs, and flyers for clubs and job opportunities.

From the waiting area you can access Room 301 to the northwest, Room 302 to the north, Room 303 to the northeast, the Student Developer Lab 1 to the southwest, the Student Developer Lab 2 to the south east, the Western Stairs to the west and the Eastern Stairs to the east.

>go southwest
Student Developer Lab 1
This room is almost completely empty... what is it even used for? The door leads to the Waiting Area.

You can see a flash drive here.

>take flash drive
Taken.

>examine flash drive
That is a small flash drive, only 1GB?

>go northeast
Waiting Area
The waiting area is cluttered with tables, chairs, and flyers for clubs and job opportunities.

From the waiting area you can access Room 301 to the northwest, Room 302 to the north, Room 303 to the northeast, the Student Developer Lab 1 to the southwest, the Student Developer Lab 2 to the south east, the Western Stairs to the west and the Eastern Stairs to the east.

>go southeast
Student Developer Lab 2

>look
Student Developer Lab 2

>go north
You can't go that way.

>go northwest
Waiting Area
The waiting area is cluttered with tables, chairs, and flyers for clubs and job opportunities.

From the waiting area you can access Room 301 to the northwest, Room 302 to the north, Room 303 to the northeast, the Student Developer Lab 1 to the southwest, the Student Developer Lab 2 to the south east, the Western Stairs to the west and the Eastern Stairs to the east.

>go north
Room 302
You can see Nick, a friend's computer and a shell here.

>log in
What do you want to log in?

>shell
You can't log in a shell.

>log in computer
(the friend's computer)
You can't log in a friend's computer.

>examine computer
It looks like he was working on a project for the professor. But he could have done that before. 
The last email he sent was at 11pm, that doesn't prove anything.

* * *

>examine shell
One of the computers in room 302 seems to have a shell open. This might give you access to computer logs, and the logs may clear Nick's name, but you can't access them on a student account. 
 Professors usually have admin account info to access the logs. Helps them determine if projects were turned in on time or not.

>open shell
That's not something you can open.

* * *

>look
Room 302
You can see Nick, a friend's computer and a shell here.

>log in to shell
I only understood you as far as wanting to log in the Door to the Rack Room.

>talk to nick
"Smells fishy in here."

>look at shel
You can't see any such thing.

>look at shell
One of the computers in room 302 seems to have a shell open. This might give you access to computer logs, and the logs may clear Nick's name, but you can't access them on a student account. 
 Professors usually have admin account info to access the logs. Helps them determine if projects were turned in on time or not.

>look at screen
You can't see any such thing.

>examine screen
You can't see any such thing.

>i
You are carrying:
  a flash drive
  a Duct Tape
  an email
  a laptop

>go to main room
now going to... Main Room
Main Room
The Main Room is filled with the low hum of Lab Computers softly minding their own business.

You can see the Admin Room to the north, the Mac Lab to the southwest, 232B to the northwest, the Coffee Room to the northeast, and the Rack Room to the east. The double doors to the south go out of the CSL and into the hallway.

The lab computer you are working at hums softly.

You can also see a Door to the Rack Room and an Admin Room door here.

>go southwest
Mac Lab
The Mac computers give off a faint glow. A strong stench fills the room.

 To the northeast is the Main Room.

A professor lies next to the Mac computer.

You can also see a Mac computer here.

>examine professor
He died wearing a really expensive jacket. You might not want to keep poking him

* * *

>examine jacket
It looks warm. Why are there so many pockets?

>examine pocket
In the The winter jacket's pocket is an account info.

>take account info
Taken.

* * *

>examine info
This account info might come in handy.

>go to 302
now going to... Room 302
Room 302
You can see Nick, a friend's computer and a shell here.

>talk to nick
"Are you sure you're the only other person here?"

>examine shell
Checking the computer logs... There are time stamps. 
It looks like Nick was working up here at the time you heard the scream and thump! That seems to be satisfying evidence, what a relief.

Now to clear your name.

Nick: Obviously I didn't do it, but what's YOUR alibi? 
 You: All we have to do is check the records on the computer I was using in the main room. Should clear my name right away.
Nick: uh huh… a rps

Main Room
The Main Room is filled with the low hum of Lab Computers softly minding their own business.

You can see the Admin Room to the north, the Mac Lab to the southwest, 232B to the northwest, the Coffee Room to the northeast, and the Rack Room to the east. The double doors to the south go out of the CSL and into the hallway.

The lab computer you are working at hums softly.

You can also see a Door to the Rack Room and an Admin Room door here.

You: Ok, here's the computer I was using. 
Nick: It... it's completely wiped… t,ooୄꂺ
You: ! Wait, no! Hold on! 
Nick: It's ok, you gave me a chance to prove myself, I'll give you the same. Come find me with some real proof.
~Nick scurries back upstairs~

You remember that they sometimes temporarily store security footage on a computer upstairs due to technical problems in the system. May be a good place to start.

>go to 301
now going to... Room 301
Room 301
The room is dimly lit. There are several rows of computers, but they are all turned off, except for one. The door leads to the Waiting Area.

You can see a 301computer (on which is a folder (in which is a video file)) here.

>examine 301computer
This computer is on. Looks like whoever was using this last forgot to log out.

On the 301computer is a folder (in which is a video file).

>examine folder
This folder is labeled "Security_Camera_Footage", maybe it contains evidence to prove you didn't murder the professor!.

In the folder is a video file.

>take video file
Taken.

This can definitely be used to clear your name of the murder. You need to show this to Nick so he'll believe you.

>go to main room
now going to... Main Room
Main Room
The Main Room is filled with the low hum of Lab Computers softly minding their own business.

You can see the Admin Room to the north, the Mac Lab to the southwest, 232B to the northwest, the Coffee Room to the northeast, and the Rack Room to the east. The double doors to the south go out of the CSL and into the hallway.

The lab computer you are working at hums softly.

You can also see a Door to the Rack Room and an Admin Room door here.

>look
Main Room
The Main Room is filled with the low hum of Lab Computers softly minding their own business.

You can see the Admin Room to the north, the Mac Lab to the southwest, 232B to the northwest, the Coffee Room to the northeast, and the Rack Room to the east. The double doors to the south go out of the CSL and into the hallway.

The lab computer you are working at hums softly.

You can also see a Door to the Rack Room and an Admin Room door here.

>go to waiting area
now going to... Waiting Area
Waiting Area
The waiting area is cluttered with tables, chairs, and flyers for clubs and job opportunities.

From the waiting area you can access Room 301 to the northwest, Room 302 to the north, Room 303 to the northeast, the Student Developer Lab 1 to the southwest, the Student Developer Lab 2 to the south east, the Western Stairs to the west and the Eastern Stairs to the east.

>talk to nick
You can't see any such thing.

>go to 302
now going to... Room 302
Room 302
You can see Nick, a friend's computer and a shell here.

"Hey! Watch this video, it proves I didn't murder the professor!
You watch him fastforward throught the time, to find when the professor dies. It looks like he died around 10:45.
And sure enough, there you are working on your program at 10:45.
Nick: Alright, I believe you.

Nick: "I took something from the professor earlier but I left it downstairs. It could help us investigate…d wh罿￿"
Nick runs downstairs.

>go downstairs
You can't see any such thing.

>go to main room
now going to... Main Room
Main Room
The Main Room is filled with the low hum of Lab Computers softly minding their own business.

You can see the Admin Room to the north, the Mac Lab to the southwest, 232B to the northwest, the Coffee Room to the northeast, and the Rack Room to the east. The double doors to the south go out of the CSL and into the hallway.

The lab computer you are working at hums softly.

You can also see a Door to the Rack Room, an Admin Room door and Nick here.

>talk to nick
Oh, by the way, I found this access key scribbled on a post-it note in the Mac Lab. Thought it might be a clue.
Here, see if you can figure anything out with it… on

>examine lab computer
You can access the terminal by logging in a lab computer. You can log in a lab computer by saying "log in lab computer"

>log in lab computer
You enter the professor's username and access key…䟔飰
You open the Lab Computer.

Terminal
From the unix Terminal you can navigate through user files with standard unix commands. To leave, simply type "log out". For help, type "help".

The lab computer you are working at hums softly.

You see that you are logged in as the professor and you can navigate his files

XxRadProf420NoScopexX: ~$

>ls
Documents, Pictures and Books
XxRadProf420NoScopexX: ~$

>cd books
XxRadProf420NoScopexX:Books ~$

>ls
Cows, Springs, Minnie Mouse and Intricacies of TF2
XxRadProf420NoScopexX:Books ~$

>vim minni
That noun did not make sense in this context.

XxRadProf420NoScopexX:Books ~$

>vim minnie
This is a file, isn't that rad?

:

>wq
XxRadProf420NoScopexX:Books ~$

>go north
You can't go that way.

XxRadProf420NoScopexX:Books ~$

>go northwest
You have successfully logged out of the lab computer
Main Room
The Main Room is filled with the low hum of Lab Computers softly minding their own business.

You can see the Admin Room to the north, the Mac Lab to the southwest, 232B to the northwest, the Coffee Room to the northeast, and the Rack Room to the east. The double doors to the south go out of the CSL and into the hallway.

The lab computer you are working at hums softly.

You can also see a Door to the Rack Room, an Admin Room door and Nick here.

>log in lab computer
You enter the professor's username and access key…pp
That's already open.

Terminal
From the unix Terminal you can navigate through user files with standard unix commands. To leave, simply type "log out". For help, type "help".

The lab computer you are working at hums softly.

You see that you are logged in as the professor and you can navigate his files

XxRadProf420NoScopexX: ~$

>log out
You have successfully logged out of the lab computer
Main Room
The Main Room is filled with the low hum of Lab Computers softly minding their own business.

You can see the Admin Room to the north, the Mac Lab to the southwest, 232B to the northwest, the Coffee Room to the northeast, and the Rack Room to the east. The double doors to the south go out of the CSL and into the hallway.

The lab computer you are working at hums softly.

You can also see a Door to the Rack Room, an Admin Room door and Nick here.

>log in lab
You enter the professor's username and access key…ᾘꂹ
That's already open.

Terminal
From the unix Terminal you can navigate through user files with standard unix commands. To leave, simply type "log out". For help, type "help".

The lab computer you are working at hums softly.

You see that you are logged in as the professor and you can navigate his files

XxRadProf420NoScopexX: ~$

>examine computer
You can access the terminal by logging in a lab computer. You can log in a lab computer by saying "log in lab computer"

XxRadProf420NoScopexX: ~$

>ls
Cows, Springs, Minnie Mouse and Intricacies of TF2
XxRadProf420NoScopexX: ~$

>help
The following commands are supported:
  ls - directory listing
  cd - change directory
  vi, vim, nano - file opening
  log out - exit
  help - get help
XxRadProf420NoScopexX: ~$

>vi minnie
What light, over yonder window breaks?

:

>wq
XxRadProf420NoScopexX:Books ~$

* * *

>x lab computer
You can access the terminal by logging in a lab computer. You can log in a lab computer by saying "log in lab computer"

>n
(first opening the Admin Room door)
It seems to be locked.

>w
You can't go that way.

>ne
Coffee Room
The Coffee Room is quite empty at this hour. It looks like someone was following a tutorial to make a duct tape wallet.

The main room is to the southwest.

You can see a Duct Tape and DT Wallet Tutorial here.

>x duct tape
Duct tape is ubiquitously useful, just ask the Mythbusters. Better take it.

>x dt wallet tutorial
It's a print-out of a web page about making wallets using only duct tape. Interesting concept.

>read dt wallet tutorial
It's a print-out of a web page about making wallets using only duct tape. Interesting concept.

>sw
Main Room
The Main Room is filled with the low hum of Lab Computers softly minding their own business.

You can see the Admin Room to the north, the Mac Lab to the southwest, 232B to the northwest, the Coffee Room to the northeast, and the Rack Room to the east. The double doors to the south go out of the CSL and into the hallway.

The lab computer you are working at hums softly.

You can also see a Door to the Rack Room and an Admin Room door here.

>w
You can't go that way.

>s
That sound in the mac lab is really eating at you. You can't bring yourself to leave just yet.

>s
That sound in the mac lab is really eating at you. You can't bring yourself to leave just yet.

>n
(first opening the Admin Room door)
It seems to be locked.

>nw
232B
232B is quite empty at this hour. It looks like some student left their USB cable in here.

The Main Room is southeast of you.

>x cable
It can be used to connect two machines together.

>take cable
Taken.

>l
232B

>l
232B

>se
Main Room
The Main Room is filled with the low hum of Lab Computers softly minding their own business.

You can see the Admin Room to the north, the Mac Lab to the southwest, 232B to the northwest, the Coffee Room to the northeast, and the Rack Room to the east. The double doors to the south go out of the CSL and into the hallway.

The lab computer you are working at hums softly.

You can also see a Door to the Rack Room and an Admin Room door here.

>sw
Mac Lab
The Mac computers give off a faint glow. A strong stench fills the room.

 To the northeast is the Main Room.

The room is dimly lit. You can see a light switch.

You can also see a Mac computer here.

>ne
Main Room
The Main Room is filled with the low hum of Lab Computers softly minding their own business.

You can see the Admin Room to the north, the Mac Lab to the southwest, 232B to the northwest, the Coffee Room to the northeast, and the Rack Room to the east. The double doors to the south go out of the CSL and into the hallway.

The lab computer you are working at hums softly.

You can also see a Door to the Rack Room and an Admin Room door here.

>nw
232B

>l
232B

* * *

>se
Main Room
The Main Room is filled with the low hum of Lab Computers softly minding their own business.

You can see the Admin Room to the north, the Mac Lab to the southwest, 232B to the northwest, the Coffee Room to the northeast, and the Rack Room to the east. The double doors to the south go out of the CSL and into the hallway.

The lab computer you are working at hums softly.

You can also see a Door to the Rack Room and an Admin Room door here.

>s
That sound in the mac lab is really eating at you. You can't bring yourself to leave just yet.

>w
You can't go that way.

>e
(first opening the Door to the Rack Room)
It seems to be locked.

>se
(first opening the Lab Computer)
It seems to be locked.

>s
That sound in the mac lab is really eating at you. You can't bring yourself to leave just yet.

>sw
Mac Lab
The Mac computers give off a faint glow. A strong stench fills the room.

 To the northeast is the Main Room.

The room is dimly lit. You can see a light switch.

You can also see a Mac computer here.

>x computer
There seems to be an email being composed.

>x email
You can't see any such thing.

>read email
You can't see any such thing.

>turn on lights
You switch the light switch on.

The bright light suddenly stings. Looks like some poor guy was working on one of the Mac computers and just fell asleep.

>x guy
It's Professor Foaad!

* * *

>x foaad
Maybe I should wake him.

>wake foaad
Is he... Is he...?

"Dead?" You jump in surprise at the voice behind you. At the door is Nick, the TA for one of your classes.

As you gaze back at the lifeless body, you surmise that he probably is dead. You also realize that you and Nick are the only two people in the CSL…better look for some evidence to figure out exactly what happened.

>i
You are carrying:
  an USB cable
  a laptop

>l
Mac Lab
The Mac computers give off a faint glow. A strong stench fills the room.

 To the northeast is the Main Room.

A professor lies next to the Mac computer.

You can also see Nick, an email and a Mac computer here.

>take email
Taken.

>drop email
Dropped.

>l
Mac Lab
The Mac computers give off a faint glow. A strong stench fills the room.

 To the northeast is the Main Room.

A professor lies next to the Mac computer.

You can also see an email, Nick and a Mac computer here.

>i
You are carrying:
  an USB cable
  a laptop

>ne
Main Room
The Main Room is filled with the low hum of Lab Computers softly minding their own business.

You can see the Admin Room to the north, the Mac Lab to the southwest, 232B to the northwest, the Coffee Room to the northeast, and the Rack Room to the east. The double doors to the south go out of the CSL and into the hallway.

The lab computer you are working at hums softly.

You can also see a Door to the Rack Room and an Admin Room door here.

* * *

>nw
232B

>se
Main Room
The Main Room is filled with the low hum of Lab Computers softly minding their own business.

You can see the Admin Room to the north, the Mac Lab to the southwest, 232B to the northwest, the Coffee Room to the northeast, and the Rack Room to the east. The double doors to the south go out of the CSL and into the hallway.

The lab computer you are working at hums softly.

You can also see a Door to the Rack Room and an Admin Room door here.

>sw
Mac Lab
The Mac computers give off a faint glow. A strong stench fills the room.

 To the northeast is the Main Room.

A professor lies next to the Mac computer.

You can also see an email, Nick and a Mac computer here.

>ne
Main Room
The Main Room is filled with the low hum of Lab Computers softly minding their own business.

You can see the Admin Room to the north, the Mac Lab to the southwest, 232B to the northwest, the Coffee Room to the northeast, and the Rack Room to the east. The double doors to the south go out of the CSL and into the hallway.

The lab computer you are working at hums softly.

You can also see a Door to the Rack Room and an Admin Room door here.

>s
Hallway
A light breeze rolls through the hallway and gives you a short chill. 

The hallway extends East and West. Going North will take you back to the main room.

>w
Western Stairs
You are at the base of the Western Stairs. Going up will take you to the third floor. Going east will take you back to the center of the hallway.

>u
Waiting Area
The waiting area is cluttered with tables, chairs, and flyers for clubs and job opportunities.

From the waiting area you can access Room 301 to the northwest, Room 302 to the north, Room 303 to the northeast, the Student Developer Lab 1 to the southwest, the Student Developer Lab 2 to the south east, the Western Stairs to the west and the Eastern Stairs to the east.

>n
Room 302
You can see a friend's computer and a shell here.

>s
Waiting Area
The waiting area is cluttered with tables, chairs, and flyers for clubs and job opportunities.

From the waiting area you can access Room 301 to the northwest, Room 302 to the north, Room 303 to the northeast, the Student Developer Lab 1 to the southwest, the Student Developer Lab 2 to the south east, the Western Stairs to the west and the Eastern Stairs to the east.

>ne
Room 303

>sw
Waiting Area
The waiting area is cluttered with tables, chairs, and flyers for clubs and job opportunities.

From the waiting area you can access Room 301 to the northwest, Room 302 to the north, Room 303 to the northeast, the Student Developer Lab 1 to the southwest, the Student Developer Lab 2 to the south east, the Western Stairs to the west and the Eastern Stairs to the east.

>nw
Room 301
The room is dimly lit. There are several rows of computers, but they are all turned off, except for one. The door leads to the Waiting Area.

You can see a 301computer (on which is a folder (closed)) here.

>se
Waiting Area
The waiting area is cluttered with tables, chairs, and flyers for clubs and job opportunities.

From the waiting area you can access Room 301 to the northwest, Room 302 to the north, Room 303 to the northeast, the Student Developer Lab 1 to the southwest, the Student Developer Lab 2 to the south east, the Western Stairs to the west and the Eastern Stairs to the east.

>se
Student Developer Lab 2

>nw
Waiting Area
The waiting area is cluttered with tables, chairs, and flyers for clubs and job opportunities.

From the waiting area you can access Room 301 to the northwest, Room 302 to the north, Room 303 to the northeast, the Student Developer Lab 1 to the southwest, the Student Developer Lab 2 to the south east, the Western Stairs to the west and the Eastern Stairs to the east.

>sw
Student Developer Lab 1
This room is almost completely empty... what is it even used for? The door leads to the Waiting Area.

You can see a flash drive here.

>ne
Waiting Area
The waiting area is cluttered with tables, chairs, and flyers for clubs and job opportunities.

From the waiting area you can access Room 301 to the northwest, Room 302 to the north, Room 303 to the northeast, the Student Developer Lab 1 to the southwest, the Student Developer Lab 2 to the south east, the Western Stairs to the west and the Eastern Stairs to the east.

>d
Western Stairs
You are at the base of the Western Stairs. Going up will take you to the third floor. Going east will take you back to the center of the hallway.

>e
Hallway
A light breeze rolls through the hallway and gives you a short chill. 

The hallway extends East and West. Going North will take you back to the main room.

>n
Main Room
The Main Room is filled with the low hum of Lab Computers softly minding their own business.

You can see the Admin Room to the north, the Mac Lab to the southwest, 232B to the northwest, the Coffee Room to the northeast, and the Rack Room to the east. The double doors to the south go out of the CSL and into the hallway.

The lab computer you are working at hums softly.

You can also see a Door to the Rack Room and an Admin Room door here.

>n
(first opening the Admin Room door)
It seems to be locked.

>ne
Coffee Room
The Coffee Room is quite empty at this hour. It looks like someone was following a tutorial to make a duct tape wallet.

The main room is to the southwest.

You can see a Duct Tape and DT Wallet Tutorial here.

>sw
Main Room
The Main Room is filled with the low hum of Lab Computers softly minding their own business.

You can see the Admin Room to the north, the Mac Lab to the southwest, 232B to the northwest, the Coffee Room to the northeast, and the Rack Room to the east. The double doors to the south go out of the CSL and into the hallway.

The lab computer you are working at hums softly.

You can also see a Door to the Rack Room and an Admin Room door here.

>s
Hallway
A light breeze rolls through the hallway and gives you a short chill. 

The hallway extends East and West. Going North will take you back to the main room.

* * *

>w
Western Stairs
You are at the base of the Western Stairs. Going up will take you to the third floor. Going east will take you back to the center of the hallway.

>undo
Hallway
[Previous turn undone.]

>undo
Main Room
[Previous turn undone.]

>sw
Mac Lab
The Mac computers give off a faint glow. A strong stench fills the room.

 To the northeast is the Main Room.

A professor lies next to the Mac computer.

You can also see an email, Nick and a Mac computer here.

>talk to nick
"I was upstairs grading some labs. What was the professor doing here?"

>g
"Something isn't right here. What was the professor working on?"

>g
"Smells fishy in here. What's on the Mac?"

>g
"Are you sure you're the only other person here?"

>g
"Something isn't right here. What was the professor working on?"

>ne
Main Room
The Main Room is filled with the low hum of Lab Computers softly minding their own business.

You can see the Admin Room to the north, the Mac Lab to the southwest, 232B to the northwest, the Coffee Room to the northeast, and the Rack Room to the east. The double doors to the south go out of the CSL and into the hallway.

The lab computer you are working at hums softly.

You can also see a Door to the Rack Room and an Admin Room door here.

* * *

>log in lab computer
You begin typing your username as password. As you do so, you begin wondering to yourself what Staley will include on the next programming test…really hope is isn컑ᑭ摯ⵥ砰㐱昶't--

Suddenly an ear-piercing shriek rings out from the Mac Lab, swiftly followed by a thunderous THUMP.

You know you should work on 357, but the sound is really bothering you, and someone might be hurt. Better go check it out.